-----------------------------------------------------------------------------------------------------------------------------------------------------------------------------------------------------
-----------------------------------------------------------------------------------------------------------------------------------------------------------------------------------------------------
-----------------------------------------------------------------------------------------------------------------------------------------------------------------------------------------------------
-----------------------------------------------------------------------------------------------------------------------------------------------------------------------------------------------------
-----------------------------------------------------------------------------------------------------------------------------------------------------------------------------------------------------
-----------------------------------------------------------------------------------------------------------------------------------------------------------------------------------------------------
-----------------------S---------------SSSSS----SSSS---------------------------------------------------------------------------------------------Q---------------------------------------------------
-----------------------------------------------------------------------------------------------------------------------------------------------------------------------------------------------------
--------USS------------------------------------------------------------------------------------------------------------------S-------------------------------------SSS-------g-----------------------
-----------------------------------------------------------------------------------------------------------------------------------------------------------------------------------------------------
------------------------------TT-----QQQ----------------------------------------TT-------C-----#----TT---------------------------------------Q-------------------------------TT----------------------
------------TT----------------TT---------------t--------------------------------TT-------------T----TT---------------gT--------------T---------------------TT----------------TT----------------------
------------TT----------------TT---------------t--------------------------------TT-------------T----TT---------------TT--------------T---------------------TT----T-----------TT----------------------
------------TT-----------gk---TT-----------k---gg-------------------------------TT---g-----k---T----TT-------K--gg---TT----k---------T---------------------TT----T-----gg----TT----k-----------------
XXXXXXXXXX--XXXXXXXXXXXXXXXX--TT---XXXXXXXXXXXXXXXXXXXXXXXXXXXXXXXXXXX---XXXXXXXXXX--XXXXXXXXXXXXXXXXXXXXXXXXXXXXXXXXXXXXXXXXXXXXXXXXXXXXXXX----XXXXXXXXXXXXXXXXXXXXXXXXXXXXXXXXXXXXX---XXXXXXXXXXXXX
XXXXXXXXXX--XXXXXXXXXXXXXXXX--TT--XXXXXXXXXXXXXXXXXXXXXXXXXXXXXXXXXXXX---XXXXXXXXXX-XXXXXXXXXXXXXXXXXXXXXXXXXXXXXXXXXXXXXXXXXXXXXXXXXXXXXXXX---XXXXXXXXXXXXXXXXXXXXXXXXXXXXXXXXXXXXXX--XXXXXXXXXXXXXX