-----------------------------------------------------------------------------------------------------------------------------------------------------------------------------------------------------
-----------------------------------------------------------------------------------------------------------------------------------------------------------------------------------------------------
-----------------------------------------------------------------------------------------------------------------------------------------------------------------------------------------------------
-----------------------------------------------------------------------------------------------------------------------------------------------------------------------------------------------------
-----------------------------------------------------------------------------------------------------------------------------------------------------------------------------------------------------
-----------------------------------------------------------------------------------------------------------------------------------------------------------------------------------------------------
--------------------------------------------------------QQ-------------------------SSS----------------------------------------------SS--------------------------------------------SS-----------------
-----------------------------------------------------------------------------------------------------------------------------------------------------------------------------------------------------
-----------------------------------------gg----S------------------------S-----------------------------------------------SS------------------------------SS------------------------------------S------
-------------------------#---------------#------------------------------------------------------------------------------------------------------------------------------------------------#----------
--------T---------------##---T------QQ---#--------------Q-QQ------------------------TT----QQ----------------------------------QQ-------TT------------------------------------------------##----T-----
--------TT--------------##---T-----------##---------------------------------#-------TT-------------------------------------T-----------TT----TT---------------------#--------------------##----TT----
--------TT-------------###---T-----------##----------------#---------------##-------TT-------------------------------------------------TT----TT-----T--------------##--------------------##----TT----
--------TT------------####---T----------###----k---#---k---#--------gg-----##---g---TT-------------k---------------------------k-gg----TT----TT-----T------g------####---------ggg-------#-----TT----
--XXXXXXXXXXXXXXXXXXXXXXXXXXXXXXXXXXXXXXXXXXXXXXXXXXXXXXXXXXXXXXXXXXXXXXXXXXXXXXXXXXXXXXXXXXXXXXXXXXXXXXXXXX---------XXXXXXXXXXXXXXXXXXXXXXXXXXXXXXXXXXXX-------XXXXXXXXXXXXXXXXXXXXX-----XXXXXXX--XX
--XXXXXXXXXXXXXXXXXXXXXXXXXXXXXXXXXXXXXXXXXXXXXXXXXXXXXXXXXXXXXXXXXXXXXXXXXXXXXXXXXXXXXXXXXXXXXXXXXXXXXXXXXX---------XXXXXXXXXXXXXXXXXXXXXXXXXXXXXXXXXXXXXXX----XXXXXXXXXXXXXXXXXXXXX-----XXXXXXX--XX