-----------------------------------------------------------------------------------------------------------------------------------------------------------------------------------------------------
-----------------------------------------------------------------------------------------------------------------------------------------------------------------------------------------------------
-----------------------------------------------------------------------------------------------------------------------------------------------------------------------------------------------------
-----------------------------------------------------------------------------------------------------------------------------------------------------------------------------------------------------
-----------------------------------------------------------------------------------------------------------------------------------------------------------------------------------------------------
-----------------------------------------------------------------------------------------------------------------------------------------------------------------------------------------------------
--------------------------------------------SSSS---------QQQQQQ--#---SS-----------------QQ---S---------S-------SSQQ-----------------------S------------------------------------------##--------------
--------------------------------------------------------------------------------------------------------------------------------------------------------------------------------------#--------------
---------S-------------------------S--------------------------------------------------------------------------------------------------------------------------------------------------##-------------
--------------------------------------------------------------------------------------------------------------------------------------------------------------------------------------##-------------
--------------------------SSSSS----------C-----S-------TS---QQQQQQ----------TT----T--QQQQ----#--QQQQ---T-------#-----------#-------------------TT----------------#--------------------###------------
----------------------------------------------------------------------------TT----T--------------------T-------#-----------#-------------------TT----------------#---------TT--------####------------
-------------------------------------------------------T--------------------TT----TT-------------------T-------##----------#-------------------TT----------------#---------TT--------###-------------
---------------g-----g---------g----------k--------g---T-----------g---ggg--TT----TT---------------gg--TT------##----gg----#---#---------------TT----------------#----g----TT----k---###-------------
XXXXXXXXXXXXXXXXXX--XXXXXXXXXXXXXXXXXXXXXXXX---XXXXXXXXXXXXXXXXXXXXXXXXXXXXXXXXXXXXXXXXXXXXXXXXXXXXXXXXXXXXXXXXXXXXXXXXX---XXXXXXXXXXXXXXXXXXXXXXXXXXXXXXXXXXX---XXXXXXXXXXXXXXXXXXXXXXXXXXXXXXXXXXXX
XXXXXXXXXXXXXXXXXX--XXXXXXXXXXXXXXXXXXXXXXXX---XXXXXXXXXXXXXXXXXXXXXXXXXXXXXXXXXXXXXXXXXXXXXXXXXXXXXXXXXXXXXXXXXXXXXXXXX---XXXXXXXXXXXXXXXXXXXXXXXXXXXXXXXXXX----XXXXXXXXXXXXXXXXXXXXXXXXXXXXXXXXXXXX