-----------------------------------------------------------------------------------------------------------------------------------------------------------------------------------------------------
-----------------------------------------------------------------------------------------------------------------------------------------------------------------------------------------------------
-----------------------------------------------------------------------------------------------------------------------------------------------------------------------------------------------------
-----------------------------------------------------------------------------------------------------------------------------------------------------------------------------------------------------
---------------------#-------------------------------------------------------------------------------------------------------------------------------------------------------------------------------
--------------------##-------------------------------------------------------------------------------------------------------------------------------------------------------------------------------
------SSS-##--------##--------------SS-------------------------------------------SS---------------------------------------------SS--------------SSSSS------------------------------------------------
----------##--------##-------------------------------------------------------------------------------------------------------------------------------------------------------------------------------
----------##-----------------------------------------------------------------------------------------------------------------------------------------------------------------------------------------
----------##-----------------------------------------------------------------------------------------------------------------------------------------------------------------------------------------
----------##----------##----T-----------------T----------------------------#------QQQ----------S-----------------------------------Q-------------QQQ-----TT---------------------SSS------------------
----------##----------##----TT----------------TT-------T-------------------#---------------------------------TT------------------------------------------TT--------------#-----------------------T---
----------##----------##----TT----------------TT---------------------------#---------------------------------T-------T-----------------------------------TT--------------#-----------------------TT--
------k---##---------###----TT------g---------TT-------T-------g-----------##--------------------------ggg-----------T---gg----------------TT------ggg---TT--------------##----k-----gg----------TT--
XXXXXXXX---XXXXXXXXXXXXXXXXXXXXXXXXXXX---XXXXXXXXXXXXXXXXXXXXXXXXXXXXXXXXXXXXXXXXXXXXXXXXXXXXXXXXX---XXXXXXXXXXXXXXXXXXXXXXX-------XXXXXXXXXXXXXXXXXXXXXXXXXXXXXXXXXXXXXXXXXXXXXXXXXXXXX------XXXXXXX
XXXXXXXX---XXXXXXXXXXXXXXXXXXXXXXXXXXX---XXXXXXXXXXXXXXXXXXXXXXXXXXXXXXXXXXXXXXXXXXXXXXXXXXXXXXXXX---XXXXXXXXXXXXXXXXXXXXXXX-------XXXXXXXXXXXXXXXXXXXXXXXXXXXXXXXXXXXXXXXXXXXXXXXXXXXXX------XXXXXXX