-----------------------------------------------------------------------------------------------------------------------------------------------------------------------------------------------------
-----------------------------------------------------------------------------------------------------------------------------------------------------------------------------------------------------
-----------------------------------------------------------------------------------------------------------------------------------------------------------------------------------------------------
-----------------------------------------------------------------------------------------------------------------------------------------------------------------------------------------------------
---------------------------------------------------------------------------------------------------------------#-------------------------------------------------------------------------------------
---------------------------------------------------------------------------------------------------------------#-------------------------------------------------------------------------------------
---------------Q----------------------------------------------SS-----------------------------------------------#----SSSS-----SSS-------QQ--------------------------------------SSSSSSSS--SSS---------
---------------------------------------------------------------------------------------------------------------#-------------------------------------------------------------------------------------
--------------------------Q------------------SSSS--------------------------#-------------------QQ-SS-------------------------------------------------------S-------S---------------------------------
----------------g----------------------------------------------------------#-------------------------------------------------------------------------------------------------------------------------
----QQQQQQQ-----TT-----------------------QQ--------------------------------#-----------------------------------QQQQ-----TT------------?QQQ------------------------------------T-------QQQQQ----------
----------------TT-------------t---------------------------------------t---#-----------------------------T--------------TT-----------------------------------TT--------------TT----------------------
----------------TT-----------------------------------------------------t---#-----------------------------T--------------TT-------------------------T---------TT--------------TT----------------------
----------------TT----------XX---###---------g--gg---------g-K---------t---#-----k-gggg---------g--------T---------gg---TT------------------gk---------------TT----k---------TT--tt------------------
-----XXXXXXXXXXXXXX--XXXXXXXXXXXXXXXXXXXXXXXXXXXXXXXXXXXXXXXXXXXXXXXXXXXXXXXXXXXXXXXXXXXXXXXXXXXXX---XXXXXXXXXXXXXXXXXXXXXXXXXXXXXXXXXXXXXXXXXX----XXXXXXXXXXXXXXXXX----XXXXXXXXXXXXXXXXXXXXXXXXXXXXX
-----XXXXXXXXXXXXX---XXXXXXXXXXXXXXXXXXXXXXXXXXXXXXXXXXXXXXXXXXXXXXXXXXXXXXXXXXXXXXXXXXXXXXXXXXXXX---XXXXXXXXXXXXXXXXXXXXXXXXXXXXXXXXXXXXXXXXXX----XXXXXXXXXXXXXXXXX----XXXXXXXXXXXXXXXXXXXXXXXXXXXXX