-----------------------------------------------------------------------------------------------------------------------------------------------------------------------------------------------------
-----------------------------------------------------------------------------------------------------------------------------------------------------------------------------------------------------
-----------------------------------------------------------------------------------------------------------------------------------------------------------------------------------------------------
-----------------------------------------------------------------------------------------------------------------------------------------------------------------------------------------------------
-----------------------------------------------------------------------------------------------------------------------------------------------------------------------------------------------------
-----------------------------------------------------------------------------------------------------------------------------------------------------------------------------------------------------
------SS--------------------------------------------SS------------------------------------------------------------------------------------------------------S--S-------------------------------------
-----------------------------------------------------------------------------------------------------------------------------------------------------------------------------------------------------
----------------------------------------------------------------------SS-------------------------------------------------------------------------------------------------------------------SSSS------
-------#----------------TT-------------------------------------------#----g--------------------------------------------------------------------------------------------------------------------------
------##----------------TT------TT-----------#---#-------------------#----TT-------Q------T--------QQQQ------TT--------------T-----Q-------------------------------------S--------------T------------
------##----------------TT------TT----------#----#------------------##----TT--------------TT-----------------TT--------------T---------------------------------TT----------------------TT------------
------##----------------TT------TT-----------#---#-----------------###----TT--------------TT---t-------------TT--------------TT--------------------------------TT----------------------TT------------
--k---##----------------TT---g--TT-----------#---#-----T----------####----TT--------------TT---t-------ggg---TT-------g--k---TT--------------------------------TT----gg----------------TT------------
XXXXXXXXXXXXXXXXXXXXXXXXXXXXXXXXXXXXXXXXXXXXXXXXXXXXXXXXXXXXXXXXXXXXXXXXXXXXXXXXXXXXXXXXXXXXXXXXXXXXXXXXXXXXXXXXXXXXXXXXXXXXXXXXXXXXXXXXXX----XXXXXXXXXXXXXXXXXXXXXXXXXXXXXXXXXXXXXXXXXXXXXXXXXXXXXXX
XXXXXXXXXXXXXXXXXXXXXXXXXXXXXXXXXXXXXXXXXXXXXXXXXXXXXXXXXXXXXXXXXXXXXXXXXXXXXXXXXXXXXXXXXXXXXXXXXXXXXXXXXXXXXXXXXXXXXXXXXXXXXXXXXXXXXXXXXX----XXXXXXXXXXXXXXXXXXXXXXXXXXXXXXXXXXXXXXXXXXXXXXXXXXXXXXX