-----------------------------------------------------------------------------------------------------------------------------------------------------------------------------------------------------
-----------------------------------------------------------------------------------------------------------------------------------------------------------------------------------------------------
-----------------------------------------------------------------------------------------------------------------------------------------------------------------------------------------------------
-----------------------------------------------------------------------------------------------------------------------------------------------------------------------------------------------------
-----------------------------------------------------------------------------------------------------------------------------------------------------------------------------------------------------
-----------------------------------------------------------------------------------------------------------------------------------------------------------------------------------------------------
---------------------------------------------SS----------------------------S-------------------------------Q--QQ----------------QQQQ---SS----------Q-------------------QQQQQ-------------------------
-----------------------------------------------------------------------------------------------------------------------------------------------------------------------------------------------------
--------------------------------SS-----------------------------------US------------------------------------------------------------------------------------------------------------------------------
-----------------------------------------------------------------------------------------------------------------------------------------------------------------------------------------------------
-------SS------------#--------------TT-----------------------------------Q--------------US------------------QQQ--T--S----TT---?QQQQQQQQQQ------------------Q----------Q-QQQQQQQ----T------Q----------
---------------------#--------------TT---------------------------------------------T-----------#-----------------T---t---TT--------------------------------------------------------T-----------------
--------------------###-------------T---------------------TT-----------------------T-----------#-----------------TT--t---TT--------------------------------------------------------T-----------------
--------ggg------g--###----k-gggt---T---------------------TT-----------------gg----T---------#-#-----------------TT--t---TT--------------k---#-----------------ggg---#-------------T-----------------
XXXXXXXXXXXXXXXXXXXXXXXXXXXXXXXXXX--XX---XXXXXXXXXXXXXXXXXXXXXXXXXXXXXXXXXXXXXXXXXXXXXXXXXXXXXXXXXXXXXXXXXXXXXXXXXXXXXXXXXXXXXXXXXXXXXXXXXXXXXXXXXXXXXXXXXXXXXXXXXXXXXXXXXXXXXXXXXXXXXXXXXXXXXXXXX---
XXXXXXXXXXXXXXXXXXXXXXXXXXXXXXXXXX---X---XXXXXXXXXXXXXXXXXXXXXXXXXXXXXXXXXXXXXXXXXXXXXXXXXXXXXXXXXXXXXXXXXXXXXXXXXXXXXXXXXXXXXXXXXXXXXXXXXXXXXXXXXXXXXXXXXXXXXXXXXXXXXXXXXXXXXXXXXXXXXXXXXXXXXXXXXX--