-----------------------------------------------------------------------------------------------------------------------------------------------------------------------------------------------------
-----------------------------------------------------------------------------------------------------------------------------------------------------------------------------------------------------
-----------------------------------------------------------------------------------------------------------------------------------------------------------------------------------------------------
-----------------------------------------------------------------------------------------------------------------------------------------------------------------------------------------------------
-----------------------------------------------------------------------------------------------------------------------------------------------------------------------------------------------------
-----------------------------------------------------------------------------------------------------------------------------------------------------------------------------------------------------
--------------------------------------------------------------SS-----------------S-------#-------QQQ-------------------------------------------------------------Q-------------------SSSS------------
----------------------------------------------------------------------------------------##-----------------------------------------------------------------------------------------------------------
--------------------------g---------------------------------------------------S--------###-------------------------------------------------------------------CS---------SSS--------------------------
--------------------------TT------------------------------------------------------g----###---------T-------------------------------------------------------------------------------------------------
--------------------------TT-----------------------------S------------------------TT---###---C-----TT--------T-------------#------------------------------------------------TT---QQ------TT----SSS---
--------------------------TT------------------------------------------------------TT---##----------TT--------T-------------#------------------------------------------------TT-----------TT----------
--------------------------TT-----------------------------------------------T---t--TT---##----------TT----t---TT------------#---------TT------#------------------------------TT-------tt--TT----------
--------------------------TT-----------gg----------------------ggg-------k----tt--TT---##------k---TT----t---TT------------#---------TT--------------------g-------g---gg---TT------gtt--TT----------
---XXXXXXXXXXXXXXXXXXXXXXXXXX-XXXXXXXXXXXXXXXXXXXX---XXXXXXXXXXXXXX--XXXXXXXXXXXXXXXX--XXXXXXXXXXXXXXXXXXX---XXXXXXXXXXXX--XXX---XXXXXXXXXXXXXXXX-XXXXXXXXXXXXXXXXXXXXXXXXXXXXXXXXXXXXX---XXXXXXXXXXX
---XXXXXXXXXXXXXXXXXXXXXXXXXX-XXXXXXXXXXXXXXXXXXXX---XXXXXXXXXXXXXX--XXXXXXXXXXXXXXXX--XXXXXXXXXXXXXXXXXXX---XXXXXXXXXXXX--XXX---XXXXXXXXXXXXXXXXXXXXXXXXXXXXXXXXXXXXXXXXXXXXXXXXXXXXXX---XXXXXXXXXXX