-----------------------------------------------------------------------------------------------------------------------------------------------------------------------------------------------------
-----------------------------------------------------------------------------------------------------------------------------------------------------------------------------------------------------
-----------------------------------------------------------------------------------------------------------------------------------------------------------------------------------------------------
-----------------------------------------------------------------------------------------------------------------------------------------------------------------------------------------------------
-------------------------------------------------------------------------------------------------------------------------------------------------------------------------------##--------------------
-------------------------------------------------------------------------------------------------------------------------------------------------------------------------------##--------------------
-----------------------------------------------------------------------------------------Q----------------SS---------------------------S-----------------USS-------------------##--------------------
-------------------------------------------------------------------------------------------------------------------------------------------------------------------------------##--------------------
----------------------S--------SS----------------------------S---------------------------------------------------S-------USSS-----------------------------------g--------------##--------------------
-------------------------------------------------------------------------#-------------------------------------------------------#---------------------------------------------##--------------------
-------QQQQ-----------------------------USS------------------------------#-----------------------TT-----QQ---------T------------Q#----------T------SSS---------#-----Q---------##----------TT--------
-------------------------------------------------------------------------#-----------#-----------TT----------------TT-----------------------TT-----------------#---------------##----------TT--------
-------------------------------------------------------------------------#-----------#-----------TT----------------TT-----------------------T------------------#---------------##----------TT--------
--------------gg-----------#-----------------------------------------k---#-------k---#-----------TT----------ggg---TT----g-------##--g------T----------g--g----#--------g------##--gg------TT--------
XXXXXXXXXXXXXXXXXXXXXXXXXXXXXXXXXXXXXXXXXXXXXXXXXXXXXXXXXXXXXXXXXXXXXXXXXXXXXXXXXXXXXXXXXXX-XXXXXXXXXXXXXXXXXXXXXXXXXXXXXXXXXXXXXXXXXXXXXXXXXXXXXXXXXXXXXXXX---XXXXXXXXXXXXXXXXXXXXXXXXXXXXXXXXXXXXXX
XXXXXXXXXXXXXXXXXXXXXXXXXXXXXXXXXXXXXXXXXXXXXXXXXXXXXXXXXXXXXXXXXXXXXXXXXXXXXXXXXXXXXXXXXXX-XXXXXXXXXXXXXXXXXXXXXXXXXXXXXXXXXXXXXXXXXXXXXXXXXXXXXXXXXXXXXXXX---XXXXXXXXXXXXXXXXXXXXXXXXXXXXXXXXXXXXXX