-----------------------------------------------------------------------------------------------------------------------------------------------------------------------------------------------------
-----------------------------------------------------------------------------------------------------------------------------------------------------------------------------------------------------
-----------------------------------------------------------------------------------------------------------------------------------------------------------------------------------------------------
---------------------------------------------------------------------------------------------------------------------------------------------------------##------------------------------------------
---------------------------------------------------------------------------------------------------------------------------------------------------------##------------------------------------------
---------------------------------------------------------------------------------------------------------------------------------------------------------##------------------------------------------
-----------------------------------------------------------SS--------------------------------------------------------------------------------------SSS---##------------------------------------------
---------------------------------------------------------------------------------------------------------------------------------------------------------##------------------------------------------
---------------------------------USS-------------------------------g----------------------------------------SS-------------------------------------------##--------------------------------SS--------
--------------------------------------------------------------------T------------------------------------------------------------------------------------##------------------------------------------
--------------------------T----------------TT--------T--------------T------SS------TT--------------SS--------------------------SC-----QQQ----------------##--------------------QQQ-------------------
--------------------------T----------------TT--------TT-------------TT-------------TT-----------------------------------------------------------g--------##------------------------------------------
--------------------------T----------------TT--------TT-------------TT-------------TT-----------------------------------------------------------TT-------#-------------------------------------------
----ggg-----------gg------T----------------TT---gg---TT----k-g------TT-----g-------T----k--------k---k---------#---------------k----------gg----TT---------XXX---------------------------------------
XXXXXXXXXXXXXXX-XXXXXXXXXXXXXXXXXXXXXXXXXXXXXXXXXXXXXXXXXXXXXXXXXXXXXXXXXXXXXXXXXXXXXXXXXX---XXXXXXXXXXXXXXXXXXXXXXXXXX-XXXXXXXXXXXXXXXXXXXXXXXXXXXXXXXXXXXXXXXXXXXXXXXXXXXXXXXXXXXXXXXXXXXXXXXXXXXXX
XXXXXXXXXXXXXXX-XXXXXXXXXXXXXXXXXXXXXXXXXXXXXXXXXXXXXXXXXXXXXXXXXXXXXXXXXXXXXXXXXXXXXXXXXX---XXXXXXXXXXXXXXXXXXXXXXXXXX-XXXXXXXXXXXXXXXXXXXXXXXXXXXXXXXXXXXXXXXXXXXXXXXXXXXXXXXXXXXXXXXXXXXXXXXXXXXXX