----------------------------------------------------------------------------------------------------------------------------------------------------------------------------------------------------------
----------------------------------------------------------------------------------------------------------------------------------------------------------------------------------------------------------
----------------------------------------------------------------------------------------------------------------------------------------------------------------------------------------------------------
----------------------------------------------------------------------------------------------------------------------------------------------------------------------------------------------------------
----------------------------------------------------------------------------------------------------------------------------------------------------------------------------------------------------------
----------------------------------------------------------------------------------------------------------------------------------------------------------------------------------------------------------
--------S-----------------------------------------------------------------------------------------------------SS------------------------S-----------------------------------------------------------------
----------------------------------------------------------------------------------------------------------------------------------------------------------------------------------------------------------
---------------------------------#--------------------------------------------------------------------------------------S---------------------------------------------------------------------------------
--------------------------------##------------------------------------------------------------------------------------------------------------------------------------------------------------------------
-----S!S--------tt-------------###---------------------------------------------SSS------------S-----SU-----------t---------------@----------------------------------------------tt----tt------------#-----
----------------tt------------####--------------------------------------tt--------------tt--------------------------------------------------------------------------------------tt----tt-------------#----
----------------tt------##---#####--##------tt---#----------tt----tt----tt--------------tt-----------------------------------------------------------t----------------tt--------tt----tt------------------
----------gg----tt------##--######--###-----tt---##---------tt-g--tt----tt-g-------g-g---t---------------g---g----t-------g-g-----------g-g---------tt----------------tt---t----tt----tt-----g-g----------
S--XXXXXXXXXXXXXXXXXXXXXXXXXXXXXXX--XXXXXXXXXXXXXXXXXXXXXXXXXXXXXXXXXXXXXXXXXXXXXXXXXXXXXXXXXXXXXXXXXXXXXXXXXXXXXXXXXXXXXXXXXXXXXXXXXXXXXXXXXXXXXXXXXXXXXXXXXXXXXXXXXXXXXXXXXXXXXXXXXXXXXXXXXXXXXXXXXXXXXX
--XXXXXXXXXXXXXXXXXXXXXXXXXXXXXXXX--XXXXXXXXXXXXXXXXXXXXXXXXXXXXXXXXXXXXXXXXXXXXXXXXXXXXXXXXXXXXXXXXXXXXXXXXXXXXXXXXXXXXXXXXXXXXXXXXXXXXXXXXXXXXXXXXXXXXXXXXXXXXXXXXXXXXXXXXXXXXXXXXXXXXXXXXXXXXXXXXXXXXXX