----------------------------------------------------------------------------------------------------------------------------------------------------------------------------------------------------------
----------------------------------------------------------------------------------------------------------------------------------------------------------------------------------------------------------
----------------------------------------------------------------------------------------------------------------------------------------------------------------------------------------------------------
----------------------------------------------------------------------------------------------------------------------------------------------------------------------------------------------------------
----------------------------------------------------------------------------------------------------------------------------------------------------------------------------------------------------------
----------------------------------------------------------------------------------------------------------------------------------------------------------------------------------------------------------
--------------------------SS----!--------------------------------------------S----------------------------------------------SS----------------------------------------------------------------------------
-----------------------------------------------------------------------------#----------------------------------------------------------------------------------------------------------------------------
---------------------------------------------------------------------------###--------------!-----------------------------------------------------------------------SS---SSSSSSSSSSSSS----------S---------
--------------------------------------------------------------------------####----------------------------------------------------------------------------------------------------------------------------
--------!S----------!---S@------------------------------------------------###---------------tt------------------##--------S@----------tt---------------#----tt--------------------------------------------
-----t----------------------------tt-------------------------t----------######------tt------tt-----------------###--------------------tt---------------#-----------------------------#--#---t---##--------
----tt----------------------------tt------tt----tt-----------tt---------#######-----tt------tt------tt--------####------------tt------tt-----t---------------------------------------#--#---tt-###--------
----tt----------------------------tt-g----tt----tt-----------tt--------####-####----tt-g-----t------tt-g------####------------tt------t------t-------------g-----------------------###--##--######--------
XXXXXXXXXXXXXXXXXXXXXXXXXXXX--XXXXXXXXXXXXXXXXXXXXXXXXXXXXXXXXXXXXXXXXXXXXXXXXXXXXXXXXXXXXXXXXXXXXXXXXXXXXXXXXXXXXXXXXXXXXXXXXXXXXXXXXXXXXXXXXXXXXXXXXXXXXXXXXXXXXXXXXXXX----XXXXXXXXXXXXXXXXXXXXXXXXXXX--
XXXXXXXXXXXXXXXXXXXXXXXXXXXX--XXXXXXXXXXXXXXXXXXXXXXXXXXXXXXXXXXXXXXXXXXXXXXXXXXXXXXXXXXXXXXXXXXXXXXXXXXXXXXXXXXXXXXXXXXXXXXXXXXXXXXXXXXXXXXXXXXXXXXXXXXXXXXXXXXXXXXXXXXX---XXXXXXXXXXXXXXXXXXXXXXXXXXXX--