----------------------------------------------------------------------------------------------------------------------------------------------------------------------------------------------------------
----------------------------------------------------------------------------------------------------------------------------------------------------------------------------------------------------------
----------------------------------------------------------------------------------------------------------------------------------------------------------------------------------------------------------
----------------------------------------------------------------------------------------------------------------------------------------------------------------------------------------------------------
----------------------------------------------------------------------------------------------------------------------------------------------------------------------------------------------------------
----------------------------------------------------------------------------------------------------------------------------------------------------------------------------------------------------------
---------------------------------------#--------------------------------------------------------------------------------------------------------------------------------------!---------------------------
---------------------------------------#------------------------------------------------------------------------------------------------------------------------------------------------------------------
----------------------S----------------#-------S!------------------------------------------------------#-------------------------------SSS!S-----------------------------------------------------#--------
--------------------------------------##--------------------------------------------------------------###----------------------------------------------------------------------------------------#--------
--------#----------S@S----!----------##-##------------------------------tt------!---------!----t---#--###-##---t----------------SS------------------------------t-----------S!SSSS-------------###----S---
--------#---------------------------###-##-----------------------------------------------------t--###-######--tt----------##------------------------------------t-----------------------------####--------
--------##-------------------------###--#--------------------tt--------t-------------------------###########--tt---------####---------------tt-----------------tt----------------------------#####--------
-----#--###-----------------------####--##--------------------t-------tt------------------g-g---#######-####--tt--------######--------------tt------------gg----t--g---------g---------------#####--------
---XXXXXXXXXXXXXXXXXXXXXXXXXXXXXXXXXXXXXXXXX---XXXXXXXXXXXXXXXXXXXXXXXXXXXXXXXXX--------XXXXXXXXXXXXXXX-XXXXXXXXXXXXXXXXXXXXXXXXXXXXXXXXXXXXXXXXXXXXXXXXXXXXXXXXXXXXXXXXXXXXXXXXXXXXXXXXXXXXXXXXXXXXXXXXXX
---XXXXXXXXXXXXXXXXXXXXXXXXXXXXXXXXXXXXXXXXX---XXXXXXXXXXXXXXXXXXXXXXXXXXXXXXXXX--------XXXXXXXXXXXXXXX-XXXXXXXXXXXXXXXXXXXXXXXXXXXXXXXXXXXXXXXXXXXXXXXXXXXXXXXXXXXXXXXXXXXXXXXXXXXXXXXXXXXXXXXXXXXXXXXXXX