----------------------------------------------------------------------------------------------------------------------------------------------------------------------------------------------------------
----------------------------------------------------------------------------------------------------------------------------------------------------------------------------------------------------------
----------------------------------------------------------------------------------------------------------------------------------------------------------------------------------------------------------
----------------------------------------------------------------------------------------------------------------------------------------------------------------------------------------------------------
----------------------------------------------------------------------------------------------------------------------------------------------------------------------------------------------------------
----------------------------------------------------------------------------------------------------------------------------------------------------------------------------------------------------------
--------------------S@S!----------------------------!S------------------------------------------------------####-----------------------------------#--#-----SS-------------------------------SSS----------
-----------------------------------------------------------------------------------------------------------#####----------------------------------##--##--------------------------------------------------
----------------------------------------------------------------------------------------------------------######----------------------!-----------##--##--------------------------------------------------
----------------------------------------##----------------------------------##--------------------------########---------------------------------###--##--------------------------------------------------
--------S-----S-------SS!S-------------#-###----------S------------------#--##------S@----SS!S---------#########-----------------------------#--####--##------!-S-----S-------------------------C---------
-------------------------------------#######---------------------t------###-###---------------------############----------------------------##-#####--##------------------------tt------------------------
----------------------------------tt#######---#-----------------tt--##--###-###--------------------#############--tt---##------t-----------###-#####--##------------------------tt------------------------
--------g-g---g--g----------------t#######----##----------------tt--##--###-#####-------gg-------g##############--tt--####-----t----------####--####--###--------------g---g----tt-g-------------g-g------
XXXXXXXXXXXXXXXXXXXXXXXXXXXXXXXXXXXXXXXXXX--XXXXXXXXXX--XXXXXXXXXXXXXX--XXX-XXXXXXXXXXXXXXXXXXXXXXXXXXXXX---XXXXXXXXXXXXXXXXXXXXXXXXXXXXXXXXXXX-XXXX-XXXXXXXXXXXXXXXXXXXXXXXXXXXXXXXXXXXXXXXX---XXXXXXXXXX
XXXXXXXXXXXXXXXXXXXXXXXXXXXXXXXXXXXXXXXXXXXXXXXXXXXXXX--XXXXXXXXXXXXXXX-XXXXXXXXXXXXXXXXXXXXXXXXXXXXXXXXXXXXXXXXXXXXXXXXXXXXXXXXXXXXXXXXXXXXXXX-XXXX-XXXXXXXXXXXXXXXXXXXXXXXXXXXXXXXXXXXXXXXXX--XXXXXXXXXX