----------------------------------------------------------------------------------------------------------------------------------------------------------------------------------------------------------
----------------------------------------------------------------------------------------------------------------------------------------------------------------------------------------------------------
----------------------------------------------------------------------------------------------------------------------------------------------------------------------------------------------------------
----------------------------------------------------------------------------------------------------------------------------------------------------------------------------------------------------------
----------------------------------------------------##----------------------------------------------------------------------------------------------------------------------------------------------------
---------------------------------------------------###----------------------------------------------------------------------------------------------------------------------------------------------------
-------------------------------------------------#####----------------##---------------------SS-------------------------------------------------SS--------------------------------------------------------
--------------------------------------------------####---------------###----------------------------------------------------------------------------------------------------------------------------------
---------------------------------------------------###--------------####------------------------SSSSSS!-----##--------------------------------------------------------------------------------------------
--------------------------------------------------###--------------#####-----------------------------------###--------------------------------------------------------------------------------------------
----------------------S-S---tt-------------S--S--###--#-----------######------------S------#--------------####---S!S----tt--------------!---------------------------------------------!------SSSSSS-S-----
----------------------------tt--------tt---------###--##---------#######------------------#--------------#####----------tt--------------------------------------------------------------------------------
----------------------------tt--------tt---------###--##-------#########----tt----------###-------------######----------tt-----tt-----t---------------##----tt------------------tt------------------------
---------------g---tg-------tt--------tt----------##--##-------#########----tt-------#--####----------########----------tt-----tt-----t------g-------###----tt--------------gg--t------------t------------
XXXXXXXXXXXXXXXXXXXXXXXXXXXXXXXXXXXXXXXXXXXXXXXXXXXXXXXXXXXXXXXXXXXXXXXXXXXXXXXXXXXXXXXXXXXXXX---XXXXXXXXXXXXXXXXXXXXXXXXXXXXXXXXXXXXXXXXXXXXXXXXXXXXXXXXXXXXXXXXXXXXXXXXXXXXXXXXXXXXXXXXXXXXXXXXXXXXXXXXX
XXXXXXXXXXXXXXXXXXXXXXXXXXXXXXXXXXXXXXXXXXXXXXXXXXXXXXXXXXXXXXXXXXXXXXXXXXXXXXXXXXXXXXXXXXXXXX---XXXXXXXXXXXXXXXXXXXXXXXXXXXXXXXXXXXXXXXXXXXXXXXXXXXXXXXXXXXXXXXXXXXXXXXXXXXXXXXXXXXXXXXXXXXXXXXXXXXXXXXXX