----------------------------------------------------------------------------------------------------------------------------------------------------------------------------------------------------------
----------------------------------------------------------------------------------------------------------------------------------------------------------------------------------------------------------
----------------------------------------------------------------------------------------------------------------------------------------------------------------------------------------------------------
----------------------------------------------------------------------------------------------------------------------------------------------------------------------------------------------------------
----------------------------------------------------------------------------------------------------------------------------------------------------------------------------------------------------------
----------------------------------------------------------------------------------------------------------------------------------------------------------------------------------------------------------
----------!-------------------------------------------------------------------------------------------------------------------------------------!---------------------------------------------------------
----------------------------------------------------------------------------------------------------------------------------------------------------------------------------------------------------------
------S--------SSS-------------##-------------------------------------------------------------------------------------------------------------------S-----------------------------------------------------
------------------------------###-----------------------------------------------------------------------------------------------------##---------------------------------#--------------------------------
------------SS!--------------####-----!---------!---!--------t------------tt------------t----------tt----------#-----#--#-----!------###--------!-----!-----!------------###------------SS!S--------------
-----------------------------####---------------------------tt------------tt------------t-----------t---------##----##--------------####--------------------------------####---------#--------------------
------------------------tt-######-------tt------------------tt------tt----tt-----------tt-----------tt----tt---#-----#-----#-------#####----------------------------t-######--#-----##---------------t----
---------g-g------gg----tt#-#####-------tt------------------tt-g----tt----tt-----g-----tt-----------tt----tt##-#--#--#-----###----#######-----g-g-------------------t#######---#----##--#-------gg---t----
-S-----XXXXXXXXXXXXXXXXXXXXXXXXXXXXXXXXXXXXXXXXXX--XXXXXXXXXXXXXXXXXXXXXXXXXXXXXXXXXXXXXXXXXXXXXXXXXXXXXXXXXXXXXXXXXXXXXXXXXXXXXXXXXXXXXXXXXXXXXXXXX--XXXXXXXXXXXXXXXXXXXXXXXXXXXXXXXXXXXXXXXXXXXXXXXXXXXX
-----XXXXXXXXXXXXXXXXXXXXXXXXXXXXXXXXXXXXXXXXXXX---XXXXXXXXXXXXXXXXXXXXXXXXXXXXXXXXXXXXXXXXXXXXXXXXXXXXXXXXXXXXXXXXXXXXXXXXXXXXXXXXXXXXXXXXXXXXXXXXX--XXXXXXXXXXXXXXXXXXXXXXXXXXXXXXXXXXXXXXXXXXXXXXXXXXXX