----------------------------------------------------------------------------------------------------------------------------------------------------------------------------------------------------------
----------------------------------------------------------------------------------------------------------------------------------------------------------------------------------------------------------
----------------------------------------------------------------------------------------------------------------------------------------------------------------------------------------------------------
----------------------------------------------------------------------------------------------------------------------------------------------------------------------------------------------------------
--------------------------------------------------------------------------------------------------------------------------------------------------------------------------------------SS------------------
-------------------------------#---------------------------------#----------------------------------------------------------------------------------------------------------------------------------------
------------------------------#SSS------------S@-----------------#------------------------------!------------------------------------------------SSSS-----------------------------------------------------
-----------------------------##----------------------------------#--#-------------------------------------------------------------------------------------------------------------------------------------
----------------------------###----------------------------------#--##--------------------------------------------SSSSS------S-------SS-------------------------------------------------------------------
----------------------------###---------------------------------##--##------------------------------------------------------------------------------------------------------------------------------------
--------------!S------!----####---S---------S------------------###--##--------------##--#------------------t----S---------SS!S----------!-----------SS-----------------##--#--#-----------##------tt------
--------------------------####--------------------------------########-------------###--##-----------------t----------------------------------------------------------###--#-###---------###--#---tt------
--------------------------####-------------------------------#########------------####--###----------------t------------------------------------tt----------------t--###########------######--##--tt------
-------------------------#--###-------------------gg-g------############---------#####--##-#-------g-----g-t-g------------------gg-g------------tt----------------t-######---#####---#######--#---tt------
XXXXXXXXXXXXXXXXXXXXXXXXXXXXXXXXXXXXXXXXXXXXXXXXXXXXXXXXXXXXXXXXXXXXXXXXXXXXXXXXXXXXXX--XXXXXXXXXXXXXXXXXXXXXXXXXXXXXXXX---XXXXXXXXXXXXXXXXXXXXXXXXXXXXXXXXXXXXXXXXXXXXXXX---XXXXXXXXXXXXXXX--XXXXXXXXXXXX
XXXXXXXXXXXXXXXXXXXXXXXXXXXXXXXXXXXXXXXXXXXXXXXXXXXXXXXXXXXXXXXXXXXXXXXXXXXXXXXXXXXXXXXXXXXXXXXXXXXXXXXXXXXXXXXXXXXXXXXX---XXXXXXXXXXXXXXXXXXXXXXXXXXXXXXXXXXXXXXXXXXXXXXXXXXXXXXXXXXXXXXXXX-XXXXXXXXXXXXX