----------------------------------------------------------------------------------------------------------------------------------------------------------------------------------------------------------
----------------------------------------------------------------------------------------------------------------------------------------------------------------------------------------------------------
----------------------------------------------------------------------------------------------------------------------------------------------------------------------------------------------------------
----------------------------------------------------------------------------------------------------------------------------------------------------------------------------------------------------------
--------------------------------------------------------------------------------------------------------------------------##------------------------------------------------------------------------------
------------------------------------------------------------------------------------------------------------------------#-##------------------------------------------------------------------------------
-----------------------------------------##-##------------------------------------------------------------------------------------------------------------------------------------------------------------
-----------------------------------------#####------------------------------------------------------------------------------------------------------------------------------------------------------------
---------------------------------------#######--------------------------------------------------------------------------------------------------------------------------------------------------!---------
--------------------------------------########--#---------------------------------------------------------------------------------------------------------------------------------------------------------
-------------S!S--------tt-----------#########--##--------------##--SU---------------------------------S#---------------------S!!-----SU--------!-------t-------tt----!---------tt------!-----------------
------------------------tt-----------#########--##-------------#-#-----------------#----------#---------------------------------------------------------tt------tt--------------tt------------------------
--------tt--------------tt-------#-#-#########-###--------------#-------------t---###--------###--------------------------------------------------------tt------tt--------------tt------------------------
--------tt---------g----tt--XX####-##-####--#--###----tt------####------gg-g--tt-#####------#####----------#------gg-----------------------t-g------gg---t-g----tt-g---------g--tt-----------------g------
--XXXXXXXXXXXXXXXXXXXXXXXXXXXXXXXXXXXXXXXX----XXXXXXXXXXXXXXXXXXXXXXXXXXXXXXXXXXXXXXXXXXXXXXXXXXXXXXXXXXXXXXXXXXXXXXXXXXXXXXXXXXXXXXXXXXXXXXXXXXXXXXXXXXXXXXXXXXXXXXXXXXXXXXXXXXXXXXXXXX--XX---XXXXXXXXXXX
--XXXXXXXXXXXXXXXXXXXXXXXXXXXXXXXXXXXXXXXXXXXXXXXXXXXXXXXXXXXXXXXXXXXXXXXXXXXXXXXXXXXXXXXXXXXXXXXXXXXXXXXXXXXXXXXXXXXXXXXXXXXXXXXXXXXXXXXXXXXXXXXXXXXXXXXXXXXXXXXXXXXXXXXXXXXXXXXXXXXXXX--XX---XXXXXXXXXXX