----------------------------------------------------------------------------------------------------------------------------------------------------------------------------------------------------------
----------------------------------------------------------------------------------------------------------------------------------------------------------------------------------------------------------
----------------------------------------------------------------------------------------------------------------------------------------------------------------------------------------------------------
----------------------------------------------------------------------------------------------------------------------------------------------------------------------------------------------------------
----------------------------------------------------------------------------------------------------------------------------------------------------------------------------------------------------------
----------------------------------------------------------------------------------------------------------------------------------------------------------------------------------------------------------
---------------#---------------------###--------------S----------------------------------------------------------------------SSSSSS-----------------------------------------------------------------------
---------------#---------------------###------------------------------------------------------------------------------------------------------------------------------------------------------------------
-------------#-#-------------------#####--------------------------------------------------------------------------------------------------------------SS-SSS---S!-------------------S---------------------
-------------###------------------######------------------------------------------------------------------------------------------------------------------------------------------------------------------
-------------###------------tt----######-------S!SSS------!---!-----------------!--------#--##-----------S!S----------------------------------SS!S---@----------------------!-----------------------------
------------####------------tt---#######----------------------------tt---------------tt--#--###-#---------------------------------------------------------------------------------------------------------
-----------###-#------------tt--########----------------------------tt---------------tt-##--###-##--------------------------------------------------------------------------------------------------------
------------####---------g-g-t-#########----------------------------tt-g------g------tt###--###-##------g-g----------------------------t--------------------------g--------------g-----g------------###---
---XXXXXXXXXXXXXXXXXXXXXXXXXXXXXXXXXXXXXXXXXXXXXXXXXXXXXXXXXX--XXXXXXXXXXXXXXXXXXXXXXXXXXXX-XXXXXXXXXXXXXXXXXXXXXXXXXXXXXXXX--XXXXXXXXXXXXXXXXXXXXXXXXXX-------XXXXXXXXXXXXXXXXXXXXXXXXXXXXXXXXXXXXXXXXXXX
--XXXXXXXXXXXXXXXXXXXXXXXXXXXXXXXXXXXXXXXXXXXXXXXXXXXXXXXXXX---XXXXXXXXXXXXXXXXXXXXXXXXXXXX-XXXXXXXXXXXXXXXXXXXXXXXXXXXXXXXX--XXXXXXXXXXXXXXXXXXXXXXXXX-------XXXXXXXXXXXXXXXXXXXXXXXXXXXXXXXXXXXXXXXXXXXX