-------------------------------------------------------------------------------------------------------------------------------------------------------------------------------------------
-------------------------------------------------------------------------------------------------------------------------------------------------------------------------------------------
-------------------------------------------------------------------------------------------------------------------------------------------------------------------------------------------
S----SSSSSSSSSSSSSSSSSSSSSSSSSSSSSSSSSSSSSSSSSSSSSSSSSSSSSSSSSSSSSSSSSSSSSSSSSSSSSSSSSSSSSSSSSSSSS---SSSSSSSSSSSSSSSSSSSSSSSSSSSSSSSSSSSSSS---SSSSSSSSSSSSSSSSSSSSSSSSSSS--SSSSSSSSSSSS----
S------------------------------------------------------------------------------------------------------------S-SSSSSSSSSSSSSSS-----------------------------------------------SSSSSS--------
S----------------------------------S-S-----------------------------------------------------------------------SSSSSSSSSSSSSSSSSS--------------------S-------------------------SSSSSS--------
S---------------------------------QS---------------------------------SSSSS-------------Q---------------------SSSSSSSSSSSSSSSSSS--------------------SS----------S-------------SSSSSS--------
S---------------------------------------------------------------TT-------------------------------------------------------------------------------------------------------------------------
S---------------------------SSSSSS------SSS---------------------TT----------------SS-------------------------------------------------------------------------------------------------------
S---------------------------SSSS--------------------------------TT--------------------------------------------------------gg---------------------------------------------------------------
S---------------------------------QQ--QQ---S--------------------TT----SSSS--------------------TT----------------SSSSSSSSSSSSSSS------S---------------------QS----------------SSSSSSS-------
S---------------------------------------------------------------TT-----SSSSS------------------TT-#---------##--SSSSSSSSSSSSSSSS----------------------------------------------SSSSSS--------
S--------SSSSSS-------------------------------------------------TT-----SSSSS---#---------------T-#--------###--SSSSSSSSSSSSSSSS---SSS------------------##--------------------S---tt--------
S---------------------------------------------------------------T--------------#---------------T-#--------###----SSSSSS--SSSS--------------------------#------------------------Stt--------
XXXXXXXX----------XX--------------XXX-XXX-XXXXXXXX----XXXXXXXXXXX--XXXXXXXXXXXXX-----XXXXXXXXXXXXX--XXXXXXXXX---XXXX-----X--XXXXXXXXXXXXXXXX-XX--------XXXXXXXXXX--XXXXXX----XXXXXXXXXX----
XXXXXXXX----------XX---------------XX-XX---XXXXXXXX---XXXXXXXXXXX-XXXXXXXXXXXXXX-----XXXXXXXXXXXXX--XXXXXXXXX---XXXX-----XX-XXXXXXXXXXXXXXXX-XX--------XXXXXXXXXX--XXXXXX----XXXXXXXXXX----