-------------------------------------------------------------------------------------------------------------------------------------------------------------------------------------------
-------------------------------------------------------------------------------------------------------------------------------------------------------------------------------------------
-------------------------------------------------------------------------------------------------------------------------------------------------------------------------------------------
S--SSSSSSSSSSSSSSSSSSSS----SSSSSSSSSSSSSSSSSSSSSSSSSSSSSSSSSSSSSSSSS---SSSSSSSSSSSSSSSSSSSSSSSSSSSSSSSSSSSSS---------SSSSSSSSSSSSS----SSSSSSSSSS---SSSSSSSSSS----SSSSSSSSSSSSSSSSSSSSSSSSSS
S------------------------------------------------------------------------------------------------------------------------------------------------------------------SSSSSSSSSSSSSSSSSSSSSS--
S----------------S----------------------------------------------------------------------------S---------------------------------------------------------------------SSSSSSSSSSSSSSSSSSSSS--
S----------------SSSS-------------------------------------------------------------------------SSS--T-----------------------------------------SSS-SSSSS------------S---SSSSSSSSSSSSSSSSSSS--
S-------------------------------------------------------------------------------------------------TT---------------------------------------------------------------------------------------
S-------------------SSS-----------------------------------------------------------S------------------------------------------------------SSS-----------------------------------------------
S-----------ooooooo-----------------------------------------------------------------------------------------------------------------------SSS----------------------------------------------
S---------SSSSSSSSS------------#----------------TT--------QQ--QQ--QQ------------------SS------SSS-TTSS------------------------------------------SSSSSS----------------SSS--SSSSSSSSSSSSSSSS
S------------------------------#-----------#----TT----------------------TT---------------------SS--T-----#---------------------------##---------SSSSSS------------#--------TT--SSSSSSSSSSSS
S-----------------------------##-------t--##----TT-----#----------------TT-------------T-------S---T----###--T---#-------------------##---------SSSSSSS----------##--------TT--SSSSSSSSSSSS
S------k-#--------------------##----------##----TT----##----------------TT------------TT----------kT----###--T---#------------------###---------SSSSSTS--------S###--------TT--SSSSSSSSS-SS
XXXXXXXXXX--XX---X---X----XXX-XXXXXX---XXXXXXXXXXX--XXXXX------X---XXXXXXXXXXXXXXXXXXXXXXXXXXXXXXXXXXXXXXXXXXXXXXXXXX-------XXXXXXXXXXX-----XXXXXXXXXXXXXXX--XXXXXX-XXXXX--XX--XXXXXXXXX-XX
XXXXXXXXXX---X---X---X-----XX-XXXXXX---XXXXXXXXXXX--XXXX-------X---XXXXXXXXXXXXXXXXXXXXXXXXXXXXXXXXXXXXXXXXXXXXXXXXX--------XXXXXXXXXXX-----XXXXXXXXXXXXXXX--XXXXXXXXXX-X--XX--XXXXXXXXX-XX