-------------------------------------------------------------------------------------------------------------------------------------------------------------------------------------------
S------------------------------------------------------------------------------------------------------------------------------------------------------------------------------------------
S------------------------------------------------------------------------------------------------------------------------------------------------------------------------------------------
S------SSSSSSSSSSSSS--------SSSSSSSSSSSSSSSSSSSSSSSSSSSSSSSSSSSSSSSS-----------SSSSSSSSSSSS--------SSSSSSSSSSSSSSSSSSSSSSSSSSSS-SSSSSSSSSSSSSSSSSSSSSSSSSSSSSSSSSSSSSSSSSSSSSSSSSSSSSSSSSSS
S----------------------------SSSSSS------------------------------------------------------------S----------------------------------SSSSSSSSSSSSS--------------------------------------------
S---------------------------SSSSSSS----------------------------------------------------------------------------------------------SSSSSSSSSSSSSS--------------------------------------------
S----------------------------SSSSS----------------SSSSSSS------------------------SSS-----------------------------------------------SSSSSSSSSSSS--------------------------------------------
S-------------------------------------TT-------------------------------------------------------------------------------------------------SS------------------------------------------------
S--------T----------------------------TT-------------------------------------------S----------SS---------S-S------------------------------S-S--------------------------------------S-------
S-------TT----------------------------TT---T--oooooooooo------------------------------ooo-----------------------------------------oo-------------------------------------TT----------------
S--------T------------TT------------SSTT--TT-SSSSSSSSSSSS--------------TT--------------SSS---------#------------------------TS--SSS-SS-----------------TT----------TT----TT---------------S
S--------TT-----------TT---------#----TT--TT----------------------T----TT-------------------------##------------------TT----TT-------------------------TT----------TT----TT--------------SS
S---------T-----------TT--------##----TT--TT----------------------TT---TT----t-------------------###-------------#----TT----TT------SSSSS--------------TT----------TT----TT-----------S--SS
S--------------kT-----TT--------##----T---TT-------------k-------kTT---TT---St-------k----------###--------------#---kTT----TT-----k------------------kTT--------kkTT---kTT--------------SS
XXXXXXXXXXXX--XXXXXXXXXX-XXX--XXXXXXXXXXXXXX-XXXXXXXXXXXXXXXXXXXXXXXXXXXXXXXXXX--XXXXXXXXXXXXXXXXXX-----------XXXXX--XXXXXXXXXXXXXXXXXXXXXXXXXXXXXXXXXXXXXXXXXXXXXXXXXXXXXX-X--------XX--XX
XXXXXXXXXXXX--XXXXXXXXXX-XXX---XXXXXXXXXXXXXXXXXXXXXXXXXXXXXXXXXXXXXXXXXXX-XXXX--XXXXXXXXXXXXXXXXX------------XXXXX--XXXXXXXXXXXXXXXXXXXXXXXXXXXXXXXXXXXXXXXXXXXXXXXXXXXXXX----------XX--XX