-------------------------------------------------------------------------------------------------------------------------------------------------------------------------------------------
S------------------------------------------------------------------------------------------------------------------------------------------------------------------------------------------
-------------------------------------------------------------------------------------------------------------------------------------------------------------------------------------------
S--SSSSSS-----SSSSSSSSSS------------SSSSSSSS--SSSSS----SSSSSSSSSSSSSSSSSSSSSSSSSSSSSSSSSSSSSSSSSSSSSSSSSSSSSSSSSSSSSSSSSSSSSSSSSS---SSSSSSSSSSSSSSSSSSSSSSSSSSS-------SSSSSSSSSSSSSSSSSSSSS
S-------------SSSSSSSSSS-------------------------------SSSSSSSSS----------------------SSSSSSSSS-------------------SSSSSSSSSSSSSSS------------------SSSSSSSSS---------------SSSSSSSSSSSSS---
S-------------SSSSSSSSSS-------------------------------SSSSSSSSS-----------------------SSSSSSS--------------------SSSSSSSSSSSSSSS-----------------SSSSSSSSSS---------------SSSSSSSSSSSSS---
S-------------SSSSSSSSSSSS-----------------S---S--SSS-SSSSSSSSSS---------------------S---SS-----------------------SSSSSSSSS--S--SS-----------------SSSSSSSSS---------------SSSSSSSSSSSSSS--
S------------------------------------------S-----------------------------------------------------------------------------------------------------------------------------------------------
S------------------------------------------------------------------------------------SS------S------SS------TT---------------------------------------------------SSS-----------------------
S-----------------------------------------------------------------------------------------------------------TT---------------SSSS--------------------oooooSS--o----------------------------
S-----------SSSSSSSSSS---SS-------QQ--------SS--SS--QQ------------------TT---S----------------QQ-------QS---TT-------SSSSSSSSSSSSSS--Q-------TSSSSSSSSSSSSSSSSSS-------SS---SSSS-SSSSSSSSSS
S-----------SSSSSSSSSS--------------------------------------------------TT---#------------------------------TT------SSSSSSSSSSS--------------T------------------------------SSS--SSSSSSSSSS
S-----------SSSSSSSSSS---S---#---------------------------SSS-----#------TT----------------------------------TT-----##SSSSSSS-SSS--------SS-----------------T----------------SSS-SSSSSSSS-SS
S-----------SSSSSSSSSS------##----------------------------------##-----kTT---S-------------------------#---kTT---k-##SSSSSSS---------------------kk-------kT-------------------SSSSSSSSS-SS
XXXXXXXXXXXXXX--XXXXXXXXXXXXXXXXXXXXXX------XXXXXXXXXXX----XXXXXXX--XXXXXXX-XXXXXXXXXXXXX--XX-XXX----XXXXXXXXXXXXXXXXXXXXXXXXXXXXXXXXXX---XXXXXXXXXXXXXXXXXXXXXXXXXXXXXXXXXXXXXXXXXXXXXX-XX
XXXXXXXXXXXXXX--XXXXXXXXXXXXXXXXXXXXXX------XXXXXXXXXXX----XXXXXXX--XXXXXXX-XXXXXXXXXXXXX--XX--XX----XXXXXXXXXXXXXXXXXXXXXXXXXXXXXXXXXX---XXXXXXXXXXXXXXXXXXXXXXXXXXXXXXXXXXXXXXXXXXXXXX-XX