-------------------------------------------------------------------------------------------------------------------------------------------------------------------------------------------
-------------------------------------------------------------------------------------------------------------------------------------------------------------------------------------------
-------------------------------------------------------------------------------------------------------------------------------------------------------------------------------------------
S----SSSSSSSSSSSSSSSSSSSSSSSSSSSSSSSSSSSSSSSSSSSSSSSSSSSSSSSSSSSSSSSSSSSSSSSSSSSSSSSSSSSSSSSSSSSSSSSSSSSSSSS------------SSSSSSS----------SSSSSSSSSSSSSSSSSSSSSSSSSSSSSSSSSSSSSSSSSSSSS-----
S---------SSSSSSSSSSSSSSSSSS-----------------------SSSSSSS---------------------------------------SSSS---------------------------------------------------------------SSSSSSSSSS-------------
S---------SSSSSSSSSSSSSSSSSS-----------------------SSSSSSS---------------------------------------SSSS----------------------------------------------------------------SSSSSSSS--------------
S----------SSSSSSSSSSSSSSSSS-----------------------SSSSSSSS--------------------SSS---------------SSSSSS--------------------SSS---------------------------------------S-SS------------------
S------------------------------------------------------------------------------------------------------------------------------------------------------------------------------------------
S---------------------------------------------------------------------------------------------------------------------------------SS-------------------S-----------------------------------
S----------------------------------------------------ooooo----------------------ooo----------T------------------------------------------------------o--------------------------------------
S----------SSSSSSSSSSSSSS-------QQ------------------SSSSSS-----------SSSSSSSSSSSSSSSS-SS----T---SSSSSS------------------------------------S----T-SS-SS----------------#---SSSSSS-----------
S----------SSSSSSSSSSSS------------#-----------T------------TT-------SSSSSSSSSSS------TT----TSSS---------tt--------##--------------------##---T---------------#------##---SSSSSS--#------SS
S----------SSSSSSSSSSSSS-----------#----------tS------------TT-------SSSSSSSSSSSS-----TT-----SSSSSSS-S---tt--S----###--------------------##--TT--------------##------#----SSSSSS-##------SS
S----------SSSSSSSSSSSS-----------##----T----tt-----kT-----kTT---------SSSSSSSSSS----kTT---k--S-------------------###--------------------##--TT--------------##-------------SSS--##------SS
S-XXX-XXXXXXXXXXXXXXXXXXXXXXXXXXXXXXXXXXXXXXXXXXXXXXXXXXXXXXXXXXXXX-XXXXXXXXXXXXXXXXXXXXXXXXXXX-XXXXXXXXXXXXXXXXXXXXX----XX------XXXXXXXXXX--XX-XXX--XX--XXXXXX-XXXXXXXXXXXXXXXXXXXXXX---XX
--XXXXXXXXXXXXXXXXXXXXXXXXXXXXXXXXXXXXXXXXXXXXXXXXXXXXXXXXXXXXXXXXX-XXXXXXXXXXXXXXXXXXXXXXXXXXX-XXXXXXXXXXXXXXXXXXXXX----XX------XXXXXX-XXX--XX-XXX------XXXXXX-XXXXXXXXXXXXXXXXXXXXXX---X-