-------------------------------------------------------------------------------------------------------------------------------------------------------------------------------------------
-------------------------------------------------------------------------------------------------------------------------------------------------------------------------------------------
-------------------------------------------------------------------------------------------------------------------------------------------------------------------------------------------
S--SSSSSSSS----SSSSSSSSSSSSSSSSSSSSSSSSSSSSSSSSSSSSSSSSSSSSSSSSSSS---SSSSSSSSSSSSSSSSSSSSSSSSSSSSSSSSSSSSSSSSSSSSS--------SSSSSSSSSSSSSSSSSSSSSS-------SSSSSSSSSSSSSSSSSSSSSS------SSSSSSSS
S--------------SSSSSSSSSSSSSSS-------SSSSSSSSSSSSSSS------SSSS-----------------------------------------------------------------------------------------------------------------------------
S---------S----SSSSSSSSSSSSSSS------SSSSSSSSSSSSSSSS--------SS-----------------------------------------------------------------------------------------------------------------------------
S--------------SSSSSSSSSSSSSSSSSS-----------SSS-SSSS----SSSSSSSS----------SS----------------------------------------------------SSSSSSSS---------------------------------------------------
S-------------------------------------------------------------------TT---------------------------------------------------------------------------------------------------------------------
S----S------------------------------------SS------------------------TT-------------------------------SS-----------------------------------SS-------------------------------------SSSSSSSSSS
S------oooo---------------------------------------------------------TT---------------------------------------------------------------------------------------------------------------------
S-----SSSSS-SS----------SS------------------------------SSSSSSSS----TT----------TT------------S-----------S---S------------------SSSSSS--------S---TT--------------------------------------
S----------------#-----SS---SS--------T---TT------##----SSSSSS-SS---TT------#--TT--------TS--ST--S--TT---T-----SS---------------SSSSS-----------#--TT----------TT--------------------------
S------------#--##----SSSSSSSS------------TT------##----SSSSSSS#S---TT-----##--TT----#----SSSSS--#--TT---T------T--------------SSSSSS----------##--TT--#-----------------------------------
S---------kk-#--#-------------------------TT------##--------S###----TT----###--TT----#--kSSSSSS---------kT------T---SkS----------------------k-##--TT--#------##--------------------------S
S--XXXXXXXXXXXXXX-----XXXXXXXXXXXXXXXXXXXXXX--XXXXXX---XXXXXXXXXX-XXXX-XXXXXX-XXXXXXXXXXXXXXXXXXXXXXXXXXXXXXXXXXXXXXXXXXXXXXXXXXX----XXXXXXXXXXXX--XX-XXXXXXXXXXXXXXXXXXXXXXXXX----------SS
S--XXXXXXXXXXXXXX-----XXXXXXXXXXXXXXXXXXXXXX--XXXXXX---XXXXXXXXXX-XXXX-XXXXXX-XXXXXXXXXXXXXXXXXXXXXXXXXXXXXXXXXXXXXXXXXXXXXXXXXXX----XXXXXXXXXXXX--XX-XXXXXXXXXXXXXXXXXXXXXXXXX----------SS