-------------------------------------------------------------------------------------------------------------------------------------------------------------------------------------------
-------------------------------------------------------------------------------------------------------------------------------------------------------------------------------------------
-------------------------------------------------------------------------------------------------------------------------------------------------------------------------------------------
S---SSSSSSSSSSSSSSSSSSSSSSSSSSSSSSSSSSSSSSSSSSSSSSSSSSSSSSSSS------SSSSSSSSSSSSSSSSSSSSSSSSSSSSSSSSS-----SSSSSSSSSSSSSSSSSSSSSSSSSSSSSSSSSSSSSSSSSSSSSSSS---SSSSSS---------SSSSSS--SSSSSSSS
S----------SSSSSSSSSSSSSSSSSSSSSSSS-----------------SSSSSSSSS-----------------SSS----------------------------------------------------------------------------------------------------------
S-----------SSSSSSSSSSSSSSSSSSSSSSS-----------------SSSSSSSS------------------SSS-----------------------------------SSSS-------------------------------------------------------------------
S-------SS--SSSSSSSSSSSSSSSSSSSSSSS-----------------SSSSS---------------------S-S------S-------------------------------------------------------------------------------------------------SS
S----------S-------------------------------------------------------------------------------------------------------------------------------------------------------------------------------
S-------SSS--------------------------------------SS------------------------------------------------------------------------------------------------------------------TT------------------SS
S----------------------ooooooooo-------------------------------------------------------------------------------------------------------T-----------------------------TT------------------S-
S-------------SSSSSSSSSSSSSSSSSSSS---------------------------------------------SSS----QQ----------------------TT--SSS-SSSSSSSSSSS------TT--------------------SSS--SS-TT------------------S-
S------------SSSSSSSSSS----------S-------------------t--------------------TT--SSSSSS----#---------------TT----TT-------SSSSSSSSS-------T---------------------SSS-----TT---ST-------#-----S-
S------------SSSSSSSSSS----------------#-------------t--S----------#------TT--SSSSSSS--#-------tt-------TT----TT------SSSSSSSSSS-------T---------------------S-S-----TT----T------##-----SS
S---------------SSSSSSSS--------------##---------S---------------k--------TT---SSSSS---##------tt-------------TT---k-T-SSS-------------T-----------------------------TT----T-------------SS
S-XX--XXXX----XXXXXXXXXXXXXXXXXXXXXXXXXX-----XX-XX---XX-XXXXXXXXXXXXXXXXXXXX--XXXXXXXXXXX--XXXXXXXXXXXXXXXXXXXXXXXXXXXXXXXXXX-XXXXXXXXXXXXXXXXXXX--XXXXXXXXXXXXXXXXXXXX--XXXXXXXXXXXXXX--X-
--XX--XXXX----XXXXXXXXXXXXXXXXXXXXXXXXXX-----XX--X---XX-XXXXXXXXXXXXXXXXXXXX--XXXXXXXXXXX--XXXXXXXXXXXXXXXXXXXXXXXXXXXXXXXXXXXXXXXXXXXXXXXXXXXXXX--XXXXXXXXXXXXXXXXXXXX--XXXXXXXXXXXXXX--X-