-------------------------------------------------------------------------------------------------------------------------------------------------------------------------------------------
-------------------------------------------------------------------------------------------------------------------------------------------------------------------------------------------
-------------------------------------------------------------------------------------------------------------------------------------------------------------------------------------------
S--SSSSSSSSSSSSSSSSSSSSSSSSSSSSSSSSSSSSSSSSSSSSSSSSSSSSSSSSS--SSSSSSSSSSSSSSSSSSSSSS---SSSSSSSSSSSSSSSS-SSSSSSSSSSSSSSSSSSSSS-----------SSSSSSS------SSSSSSSSSSSSSSSSSSSSSSSSSSSSSSSSSSSSSS
S------------------------SSSSSSSSSSSSSSSSSSSSSSSSSSS--------------SSSSSS---------------SSSSSSS------------------SS---------------------------------------------------------------------S-SS
S------------------------SSSSSSSSSSSSSSSSSSSSSSSSSSSSS------------SSSSSS---------------SSSSS-------------------SSSS--------------------------------------------------------------------S-S-
S------------------------SSSSSSSSSSSSSSSSSSSSSSSSSSSSSSSSSS-------SSSSSS---------------S-----------------------SSSS-----------------------------------------------------------SS-----------
S------------------------------------------------------------------------------------------------------------------------------------------------------------------------------------------
S------------------------SSS------------------------------S-------SSS---------------------SS-----------------------------------------------------------------------------S-----------------
S-------------------------------------------------------------------------------------------------------------oooo-------------------------------------------------------------ooS---------
S--SSS-----------------------SSSSSSSSSSSSS--------SS-------------------------SSSS-QQ----SS-------------------SSSSSS-S-TT-----------------------------------------------------SSSSS-------SS
S------------------#---------SSSSSSSSS------------SS----------------------#---------#------------------#---------------T---------------------------T---------------TT--------------------SS
S-----------------##---------SSSSSSSSS-----------------------#-----------##--------##-----------------##---------------T---------tt--------TT------T----#-ttt----------------------------SS
S-----------------##----------SSSSS--------------------------#---------k-##-------###----------k-#----##-------------k-T---------t---------------k-T---##--t----------------------k----k-SS
XXXXXXXXXXXXXXXXXXXX-------XXXXXXXXXXX-----XXXXXXXXXXXXXXXXXXXX------XXXXXXXX-XXXXXXX------XXXXXXXXXXXX----XX--XX-XXXXXXXXXXXXXXX--XXXXXXXXXXXXXX-XXXXXXXXXXXXXXXXXXX---XXXXXXXXXXXXXXXXXXX
XXXXXXXXXXXXXXXXXXXX-------XXXXXXXXXXX-----XXXXXXXXXXXXXXXXXXXX------XXXXXXXX-XXXXXXX------XXXXXXXXXXXX----XX------XXXXXXXXXXXXXX---XXXXXXXXXXXXX-XXXXXXXXXXXXXXXXXXXXXXXXXXXXXXXXXXXXXXXXX