-------------------------------------------------------------------------------------------------------------------------------------------------------------------------------------------
-------------------------------------------------------------------------------------------------------------------------------------------------------------------------------------------
S------------------------------------------------------------------------------------------------------------------------------------------------------------------------------------------
S--SSSSSSSSSSSSSSSSSSSSSSS--SS-------SSSSSSSSSSSSSSSSSSSSSSSSSSSSSSSSSSSSSSSSSSSSSSSSSSSSSSSSSSSSSSSSSSSSSSSSSSSSSSSSSSSSSSS----------SSSSSSSSSSSSSSSSSSSSSS-------SSSSSS---SSSSSSSSSSSSSSS
S---------------------------------------------SSSSSSSSSSS-------------------------------------------------------------------------SSSSSSSSSSSSSSS------------------------------------------
S---------------------------------------------SSSSSSSSSSSS-----------------------------------------------------------------------SSSSSSSSSSSSSSSS------------------------------------------
S------SSS-------------------------------------SSSSSSSSSSS-----------------------------------------------------------------------SSSSSSSSSSSSSSSSS-----------------------------------------
S--------------------------------------------------------------------------------------------------------------------------------S---------------------------------------------------------
S----SSS---------------------S-------------------------------------------------------------------------------------------------------------------------------------------------SS----------
S------------------------------------------oooooooooooo-S-------------------------------------------TT---------------------------Soooo-----S-----------------------------------------------
S-------------------------------S---------SSSSSSSSSSSSSSSSS----S--QQ---S-------------------------SS-TT----T-S-------TT---SSS-----SSSSSSSSSSSSSSS----------SS---------Q---------------------
S---------------TT----------TT---------------------SSSSSS--S-----------#----------------------------TT----TT--------TT-----------------SSSSSSS-----------S---------------------------------
S------------#---T----------TT--------------------SSSSSSS--#----------------------------------------TT----TT---T----TT-----------t-----SSSSSSS-----------T--------------------------#---SSS
S------------#-------------kTT---kS--------------SSSSSSSS-S#----------------------------------------TT---kTT---T---TT-----------kT---kSSSSSSSS---------kk--------------##----------------SS
S---------XXXX---X-------XX-XXXXXXXXXXXXXXXXXXXXXXXXXXXXXXXX---XXXXX--------XXXXXXXXXXXXXXXXXXXXXXXXXXXXXXXXXXXXXXXXXX-XXXXXXXXXXXXXXXXXXXXXX-XXXXXXXXXXXXXXXXXXXXXXXXXXX------------------
S---------XXXX--XX-------X--XXXXXXXXXXXXXXXXXXXXXXXXXXXXXXXX---XXXXX--------XXXXXXXXXXXXXXXXXXXXXXXXXXXXXXXXXXXXXXXXXXXXXXXXXXXXXXXXXXXXX-----XXXXXXXXXXXXXXXXXXXXXXXXXXX------------------