----------------------------------------------------------------------------------------------------------------------------------------------------------------------------------------------------------
----------------------------------------------------------------------------------------------------------------------------------------------------------------------------------------------------------
----------------------------------------------------------------------------------------------------------------------------------------------------------------------------------------------------------
----------------------------------------------------------------------------------------------------------------------------------------------------------------------------------------------------------
----------------------------------------------------------------------------------------------------------------------------------------------------------------------------------------------------------
-----------------------------------------------------------------------------------------------------------------------------------------------###--------------------------------------------------------
----------------------------------------------------------------------------------SS-----------------------------------------------------------###--------------------------------------------------------
----------------------------------------------------------------------------------------------------------------------------------------------####--------------------------------------------------------
-------------------------------------------------------------------###--------------------------------------!-----SSS-----------------------######--------------------------------------------------------
------------------------------------------------------------------####------------------------------------------------------------##--------######--------------------------------------------------------
-------------S!S--------------------------S@S!S----------------#######------------------!---SS------------------------------------##-------#######----------!------S--!-------------------!---SSSS!S------
----------------------------------------------------------##--########----------------------------------------------------------####--#---########----tt--------------------------------------------------
---------#------------------tt-----------------------------#--########------------#---------------------------tt----------------####--##-#########----tt--------tt--------------tt------------------------
----------#-----------g--g--tt------------------------g-g-##--###-####------g------#--------------------------tt----------------####--##-#########----tt--g-----tt---------g----tt------------------------
XXXXXXXXXXXXXXXXXXXXXXXXXXXXXXXXXXXXXXXXXXXXXXXXXXXXXXXXXXXX--XXX-XXXXXXXXXXXXXXXXXXXXXXXXXXXXXXXXXXXXXXXXXXXXXXXXXXXXXXXXXXXXXXXXXX-XXXXXXXXXXXXXXXXXXXXXXXXXXXXXXXXXXXXXXXXXXXXXXXXXXXXXXXXX----XXXXXXX-
XXXXXXXXXXXXXXXXXXXXXXXXXXXXXXXXXXXXXXXXXXXXXXXXXXXXXXXXXXXXX-XXX-XXXXXXXXXXXXXXXXXXXXXXXXXXXXXXXXXXXXXXXXXXXXXXXXXXXXXXXXXXXXXXXXXXXXXXXXXXXXXXXXXXXXXXXXXXXXXXXXXXXXXXXXXXXXXXXXXXXXXXXXXXX-----XXXXXXX-