----------------------------------------------------------------------------------------------------------------------------------------------------------------------------------------------------------
----------------------------------------------------------------------------------------------------------------------------------------------------------------------------------------------------------
----------------------------------------------------------------------------------------------------------------------------------------------------------------------------------------------------------
----------------------------------------------------------------------------------------------------------------------------------------------------------------------------------------------------------
----------------------------------------------------------------------------------------------------------------------------------------------------------------------------------------------------------
----------------------------------------------------------------------------------------------------------------------------------------------------------------------------------------------------------
-----------------------------------------------#--##-------------------------------SSS-----S----------------------------------------SSSS------------------------------------------------------------------
----------------------------------------------######--------------------------------------g---------------------------------------------------------------------------------------------------------------
-------------------------------------##------#######------------------------------------S-----------------------------------------------------------------------------------------------------------------
------------------------------------###-----########------------------------------------------------------------------------------------------------------------------------------------------------------
--------S@S---------S--------------######--#########--------------------------------!-----!-----------------S@S---------------#S-SS-SS!S----------S---SS!S------tt-------------#--#-----------------------
---------------------t------------#######---########-------------#------------t---------------------------------------------------------------------------------tt------------##--#-----------------------
--------------------tt-----------#########--########------#-----##-----------tt------------------------------------------t--#---------------tt------------------tt------------##--#-t---------------------
-----------------g--tt----------######-###--###-####------##--#####--------g-tt-----------g-g----------g-----------g-----t-##--#------------tt-g-----g-g----gg---t---------t####----tt--------g-----------
XXXXXXXXXXXXX-XXXXXXXXXXXXXXXXXXXXXXXX-XXX--XXX-XXXXXXXXXXXXXXXXXXXXXXXXXXXXXXXXXXXXXXXXXXXXXXXXXXXXXXXXXXXXXXXXXXXXXXXXXXXXXXXXXXXXXXXXXXXXXXXXXXXXXXXXXXXXXXXXXXXXXXXXXXXXXXXXX-XXXXXXXXXXXXXXXXXXXXXXX-
XXXXXXXXXXXXX-XXXXXXXXXXXXXXXXXXXXXXXXXXXX--XXXXXXXXXXXXXXXXXXXXXXXXXXXXXXXXXXXXXXXXXXXXXXXXXXXXXXXXXXXXXXXXXXXXXXXXXXXXXXXXXXXXXXXXXXXXXXXXXXXXXXXXXXXXXXXXXXXXXXXXXXXXXXXXXXXXXXXXXXXXXXXXXXXXXXXXXXXXXX