----------------------------------------------------------------------------------------------------------------------------------------------------------------------------------------------------------
----------------------------------------------------------------------------------------------------------------------------------------------------------------------------------------------------------
----------------------------------------------------------------------------------------------------------------------------------------------------------------------------------------------------------
----------------------------------------------------------------------------------------------------------------------------------------------------------------------------------------------------------
----------------------------------------------------------------------------------------------------------------------------------------------------------------------------------------------------------
----------------------------------------------------------------------------------------------------------------------------------------------------------------------------------------------------------
----------------------------------------------------------------S!SSSS--SS-SSSSS--------------------------------------------------------------------------------------------------------------------------
----------------------------------------------------------------------------------------------------------------------------------------------------------------------------------------------------------
--------------------SSSS!S----------------------------SS!--------------------------------------------------------------------------------------------------#----------------------------------------------
----------------------------------------------------------------------------------------------##--##----------------------------#-------------------------##----------------------------------------------
----------------------------SS!S-------------------------------S!S----S@S---S@S!S------------###--##S-------------tt---------##-##----------------S------###-----##---------------------------------------
---------------------------------------------#----------------------------------------------####--##-------#------tt--------######----------tt----------####----####--------------------------------------
---------------------------------------------##---------C----------------------------------#####--##-------##-----tt-------#######--tt------tt---------#####-----###---------------------#---##-----------
--------g----------------g-------------------###---------------g-------------g-------g----######--##-------###----tt------########--tt-g----tt----g-g-######-----###--------------------##---###----------
---XXXXXXXXXXXXXXXXXXXXXXXXXXXXXXXXXXXXXXXXXXXXXXXXXXXXXXXXXXXXX---XX---XXXXXXXXXXXXXXXXXXXXXXXX--XXXXXXXXXXXXXXXXXXXXXXXXXXXXXXXXXXXXXXXXXXXXXXXXXXXXXXXXXX----XXXXXXXXXXXXXXXXXXXXXXXXXXXXXXXXXXXXXXXXX-
--XXXXXXXXXXXXXXXXXXXXXXXXXXXXXXXXXXXXXXXXXXXXXXXXXXXXXXXXXXXXXX---XX---XXXXXXXXXXXXXXXXXXXXXXXXXXXXXXXXXXXXXXXXXXXXXXXXXXXXXXXXXXXXXXXXXXXXXXXXXXXXXXXXXXXXXXXXXXXXXXXXXXXXXXXXXXXXXXXXXXXXXXXXXXXXXXX-X-