----------------------------------------------------------------------------------------------------------------------------------------------------------------------------------------------------------
----------------------------------------------------------------------------------------------------------------------------------------------------------------------------------------------------------
----------------------------------------------------------------------------------------------------------------------------------------------------------------------------------------------------------
----------------------------------------------------------------------------------------------------------------------------------------------------------------------------------------------------------
----------------------------------------------------------------------------------------------------------------------------------------------------------------------------------------------------------
----------------------------------------------------------------------------------------------------------------------------------------------------------------------------------------------------------
----------------------------------------------------------##------------------SSS---------------------------------------------------------SS-----------S----SSSS------------------------------------------
---------------------------------------------------------###----------------------------------------------------------------------------------------------------------------------------------------------
------------S@S-----------------------------------------####--------S---!------------------------------------------------------------------------------------------------------S@S------------------------
-------------------------------------------------------#####----------------------------------##-------------------------#--------------------------------------------------------------------------------
------------------------------------------S@S#----##--######--------------------S----------#--##--------S-------!-------##--------------------------------SS!S------------S---------------tt--------------
--------------------------------t-----------##--#-##--#######-----------------------------##--##-----------------------#-#--------------------------------------------------------------------------------
--------------------------------tt--tt-----#-#--####--########---------------------------###--##----------------------#--#-------------t------------------------------------------------------------------
---------g----------------------tt--tt----####--####--#########------------g------------####--###---gg-------------------#-------------t-------------------------------g---------------g------------g-#---
---XXXXXXXXXXXXXXXXXXXXXXXXXXXXXXXXXXXXXXXXXXXXXXXXXXXXXXXXXXXXXXXXXXXXXXXXXXXXX--XXXXXXXXXX--XXXXXXXXXXXXXXXXXXXXXXXXXXXXXXXXXXXXXXXXXXXXXXXXXXXXXXXXXXXXXXXXXXXXXXXXXXXXXXXXXXXXXXXXXXXXXXXXXXXXXXXXXXX-
---XXXXXXXXXXXXXXXXXXXXXXXXXXXXXXXXXXXXXXXXXXXXXXXXXXXXXXXXXXXXXXXXXXXXXXXXXXXXX--XXXXXXXXXXX-XXXXXXXXXXXXXXXXXXXXXXXXXXXXXXXXXXXXXXXXXXXXXXXXXXXXXXXXXXXXXXXXXXXXXXXXXXXXXXXXXXXXXXXXXXXXXXXXXXXXXXXXXXX-