----------------------------------------------------------------------------------------------------------------------------------------------------------------------------------------------------------
----------------------------------------------------------------------------------------------------------------------------------------------------------------------------------------------------------
----------------------------------------------------------------------------------------------------------------------------------------------------------------------------------------------------------
----------------------------------------------------------------------------------------------------------------------------------------------------------------------------------------------------------
-----------------------------------------------------------------------------------------------------------#####------------------------------------------------------------------------------------------
----------------------------------------------------------------------------------------------------------######------------------------------------------------------------------------------------------
-------------------------------------------------------------------------------------------------------#--#####SSSS---------------------------------------------------------------------------------------
-------------------------------------------------------------------------------------------------------########-------------------------------------------------------------------------------------------
------------------------------------S-----------------------------------------------------------------########--------------------------------------------------------------------------------------------
-----------------------------------------------------------------------------------------------------#########--#-----------------------------------------------------------------------------------------
------!---------------!-----------------------!------------------##-###------SSS!S------S----------###########--#------------------------------------###-##---------------------------------!---------tt--
--------------------------------------------------##------------###-##----------------------------######---###--#-----------------------------------#######-------tt------------#---------------------tt--
----------tt-------------------t------tt----#-----##-----------#######--------------------------########---###----tt---------t---------------------#########------tt------tt-----#--#-----------------tt--
----------tt-------------------t-g----tt-----#---###-g--------#########------g-------g-----------#######-----#-----t-----g---t--------------------######-###------tt------tt-g---#--##----------gg-g--tt--
XXXXXXXXXXXXXXXXXXX-XXXXXXXXXXXXXXXXXXXXXXXXXXXXXXXXXXXXXXXXXXXXXXXXXXXXXXXXXXXXXXXXXXXXXXXXXXXXXXXXXXXXXXXXXXXXXXXXXXXXXXXXXXXXXXXXXXXXXXXXXXXXXXXXXXXXXXXXXXXXXXXXXXXXXXXXXXXXXXXXXXXXXXXXXXXXXXXXXXXXX-
XXXXXXXXXXXXXXXXXXX-XXXXXXXXXXXXXXXXXXXXXXXXXXXXXXXXXXXXXXXXXXXXXXXXXXXXXXXXXXXXXXXXXXXXXXXXXXXXXXXXXXXXXXXXXXXXXXXXXXXXXXXXXXXXXXXXXXXXXXXXXXXXXXXXXXXXXXXXXXXXXXXXXXXXXXXXXXXXXXXXXXXXXXXXXXXXXXXXXXXXX-