----------------------------------------------------------------------------------------------------------------------------------------------------------------------------------------------------------
----------------------------------------------------------------------------------------------------------------------------------------------------------------------------------------------------------
----------------------------------------------------------------------------------------------------------------------------------------------------------------------------------------------------------
----------------------------------------------------------------------------------------------------------------------------------------------------------------------------------------------------------
----------------------------------!-----------------------------------------------------------------------------------------------------------------------------------------------------------------------
--------------------------------------------------------------------------------------------------------------------------------#-------------------------------------------------------------------------
----------SS@S------------------------------------------------------------SS!S-------------------------------------------------###-------------------------------------------------------#-----S----------
-------------------------------------------------------------------------------------------------------------------------------###------------------------------------------------------##----------------
----------------------------------------##------------------------------------------------------------------------------------####-------------------------------------#---------------###--#-------------
---------------------------------------###------------------------------------------------------------------------------------####------------------------------------##--------------####--##------------
----------SS!S-------t---@------------####----------------------------------S--S----------------------#----------------------#####--S-------tt----!------------------###--##-------#-#####--##------------
---------------------t---------------#####------------------------------------------------------------##--------------------######----------tt----------------------####--###-----########--##------------
------tt-------------t-------------t######--------t--------------------------------------------tt-----##--#----------------#######----------tt------------------tt-#####--####---#############------------
------tt--------gg---t------------t#######--------tt--------------t----#-----t-g---------------tt-----##--##---------------#######----------tt------------------tt######--####--#########-###-------------
--XXXXXXXXXXXXXXXXXXXXXXXXXXXXXXXXXXXXXXXXXXXXXXXXXXXXXXXXXXXXXXXXXXXXXXXXXXXXXXXXXXXXXXXXXXXXXXXXXXXXXXXXXXXXXXXXXXXXXXXXXXXXXXXXXXXXXXXXXXXXXXXXXXXXXXXXXXXXXXXXXXXXXXXXXXXX--XXXXXXXX--XXXXXXXXXXXXXXXX
--XXXXXXXXXXXXXXXXXXXXXXXXXXXXXXXXXXXXXXXXXXXXXXXXXXXXXXXXXXXXXXXXXXXXXXXXXXXXXXXXXXXXXXXXXXXXXXXXXXXXXXXXXXXXXXXXXXXXXXXXXXXXXXXXXXXXXXXXXXXXXXXXXXXXXXXXXXXXXXXXXXXXXXXXXXXX-XXXXXXXXXXXXXXXXXXXXXXXXXXX