----------------------------------------------------------------------------------------------------------------------------------------------------------------------------------------------------------
----------------------------------------------------------------------------------------------------------------------------------------------------------------------------------------------------------
----------------------------------------------------------------------------------------------------------------------------------------------------------------------------------------------------------
----------------------------------------------------------------------------------------------------------------------------------------------------------------------------------------------------------
----------------------------------------------------------------------------------------------------------------------------------------------------------------------------------------------------------
----------------------------------------------------------------------------------------------------------------------------------------------------------------------------------------------------------
----------#----------------------S!--------------------------------------------------------------------------------------------------------SSS--!----------------------------------------SSSSS!S----------
---------###----------------------------------------------------------------------------------------------------------------------------------------------------------------------------------------------
---------##-----------------------------------------------------------------------------------------------------------------------------------------------------------------------------------------------
--------###-----------------------------------------------------------------------------------------------------------------------------------------------------------------------------------------------
-------####-----S----#----##----------tt------tt----!-------------SS!S---------------------S#---------SS!S----S---------------------SS!S---------S-S----------------SS!---tt--------tt--------tt----------
-------####---------##--#-------------tt------tt--------------------------------------------------------------------------------------------------------------------------tt--------tt--------tt----------
------#####--------###--###-----------tt------tt--------------------------------------tt--------------------------------------------------------------------tt--tt--------tt--------tt--------tt----------
-----#######-------###--####----------tt--gg--tt-------------------------g-g----------tt-----#-------------------------------------------------g-----t------tt--tt--------tt----gg--tt--------tt-g--------
S--XXXXXXXXXXXXXXXXXXX--XXXXXXXXXXXXXXXXXXXXXXXXXXXXXXXXXXXXXXXXXXXXXXXXXXXXXXXXXXXXXXXXXXXXXXXXXXXXXXXXXXXXXXXXXXXXXXXXXXXXXXXXXXXXXXX-XX----XXXXXXXXXXXXXXXXXXXXXXXXXXXXXXXXXXXXXXXXXXXXXXXXXXXXXXXXXXXX
---XXXXXXXXXXXXXXXXXXXX-XXXXXXXXXXXXXXXXXXXXXXXXXXXXXXXXXXXXXXXXXXXXXXXXXXXXXXXXXXXXXXXXXXXXXXXXXXXXXXXXXXXXXXXXXXXXXXXXXXXXXXXXXXXXXXX-XX---XXXXXXXXXXXXXXXXXXXXXXXXXXXXXXXXXXXXXXXXXXXXXXXXXXXXXXXXXXXXX