----------------------------------------------------------------------------------------------------------------------------------------------------------------------------------------------------------
----------------------------------------------------------------------------------------------------------------------------------------------------------------------------------------------------------
----------------------------------------------------------------------------------------------------------------------------------------------------------------------------------------------------------
----------------------------------------------------------------------------------------------------------------------------------------------------------------------------------------------------------
----------------------------------------------------------------------------------------------------------------------------------------------------------------------------------------------------------
--------------------------------------------------------------------------------------------------#-------------------------------------------------------------------------------------------------------
--------------------S--------------------------------------------##----S-------------------------###-----------------------------------------------#------------------------------------------------------
------------------------------------------------------------------------------------------------####----------------------------------------------##------------------------------------------------------
-----------------------------------------------------------------------------------------------#####---------------------------------------------###--SS-S------------------------------------------------
----------------------------------------------------------------------------------------------######-------------------------------------------#####------------------------------------------------------
----------------------------------SU----!-------##------------SS--SS----!--------------------#######----S-----------------------tt------------######----!---------!---------S-----------------S-----------
--------------###-----------tt-----------------###------------------------------------------########-----------------------------t----------########------------------------------------------------------
---------------##---tt------tt----------------####-------tt-------------------------------t#########-----------------------------t----------########--#---------------------------------------------------
---------------#-#--tt---g--tt-g-------------#####--------t-----------g-g-----------------t#########-----------------------------t-----g---#########--#------------------g--------------------------------
XXXXXXXXXXXXXXXXXXXXXXXXXXXXXXXXXXXXXXXXXXXXXXXXXXXXXXXXXXXXXXXXXXXXXXXXXXXXXXXXXXXXXXXXXXXXXXXXXXXXXXXXXXXXXXXXXXXXXXXXXXXXXXXXXXXXXXXXXXXXXXX-XXXXXXXXXXXXXXXXXXXXXXXXXXXXXXXXXXXXXXXXXXXXXXXXXXXXXXXXXX
XXXXXXXXXXXXXXXXXXXXXXXXXXXXXXXXXXXXXXXXXXXXXXXXXXXXXXXXXXXXXXXXXXXXXXXXXXXXXXXXXXXXXXXXXXXXXXXXXXXXXXXXXXXXXXXXXXXXXXXXXXXXXXXXXXXXXXXXXXXXXXX-XXXXXXXXXXXXXXXXXXXXXXXXXXXXXXXXXXXXXXXXXXXXXXXXXXXXXXXXXX