-------------------------------------------------------------------------------------------------------------------------------------------------------------------------------------------------------------------------------------------------------------------------------------------------------------------------------------------------------------------------------------
-------------------------------------------------------------------------------------------------------------------------------------------------------------------------------------------------------------------------------------------------------------------------------------------------------------------------------------------------------------------------------------
----------SSS-S----------------------------------------------------------------------------------------------------------------------------------------------------------------------------------------------------------------------------------------------------------------------------------------------------------------------------------------------------------------------
-------------------------------------------------------------------------------------------------------------------------------------------------------------------------------------------------------------------------------------------------------------------------------------------------------------------------------------------------------------------------------------
-------------------------------------------------------------------------------------------------------------------------------------------------------------------------------------------------------------------------------------------------------------------------------------------------------------------------------------------------------------------------------------
-------------------------------------------------------------------------------------------------------------------------------------------------------------------------------------------------------------------------------------------------------------------------------------------------------------------------------------------------------------tt----------------------
------------------------------------------------------------------------------------------------------SSS------------------------------------------------------------------------------------------------SSCSSS------------------------------------------------------------#---------------------------------------------------------##----------------------tt----------------------
--------------o------------------------------------------------------------------------------------------------------------------------------------------------------------------------------------------------------------------------------------------------------------#-------------------------------------------------------####----------------------tt----------------------
-----------------------------------------------------------------------------------------------------------------------SSSSS-----------------------------------------------------------------------t-----------------------------------------------------------------------#-----------------------------------------------------######----------------------tt----------------------
--oo-----------------------------------------------------------------------------------------------------------------------------------------------------------------------------------------------t---------------------------------------------------------------------#-#---------------------------------o-------------------######----------------------tt----------------------
--------------------------T------------------------------------------------------------------------------T-----------#-----------------------------------------------T---T---------------------#---t-------o-----oo---------TT-------------------------------------------------------------------------##----------------------#-#-#-##----------------------tt----------------------
-------------------------TT-----------------------------------------------------------------------------TT-----------#-----------------------------------------------TT--T---------------------#---#-------------------------------------------------------------------------------TT------------------##------------TT---------##-#---------------------TT--tt----------------------
-------------------------TT------------------#-------T-----------------------------T--tt----------------TT-----------#-----------------------------------------------TT-tt---T-------------#---#---#---TT------------------------------------------------------------#-------------TT---T------------#-##------------TT--------###-#-------------------------t-----------------------
-------------------------TT---------------ggg#---gg---------------kkk---kk--ggg-------tt----------------TT------k-k#-#------------------k-k-------ggg------ggg-------TT-tt---T----k-ggg--g-#---#---#--kTT-------------ggg---------------kg------ggg----kk------------#-#-----------TT--------------k-#-##------------TT----ggg####-#-------g-----k-k-----------------------gg----k---
--------XXXXXXXXXXXXXXXXXXXX---X----XXXXXXXXXXXXXXXXXXXXX-X-XXXXXXXXXXXXXXXXXXXXXXXXX-XXXXXXXXXXXXXXXXXXXXX-X-XXXXXXXXXXXXXXXXXXX-X-XXXXXXXXXXXXXXXXXXXXXXXXXXXXXXXX-XX-XXXXXXXXXXXXXXXXXXXXXXXXXXXXXXXXX-X-X-XXXXXXXXXXXXXXXXXXXXXXXXXXXXXXXXXXXXXXXXXXXXXXXXXXXXXXXX-XXXXXXXXXXXXXXXXXXXXXXXXXXXXXXX-XXXXXX--XXXXXXXXXXXXXXXXXXX-XX--XXXXXXXXXXXXXXXXX-XX--------XXXXXXXXXXXXXXXXXX
--------XXXXXXXXXXXXXXXXXXXX---X----XXXXXXXXXXXXXXXXXXXXX-X-XXXXXXXXXXXXXXXXXXXXXXXXX-XXXXXXXXXXXXXXXXXXXXX-XXXXXXXXXXXXXXXXXXXXX-XXXXXXXXXXXXXXXXXXXXXXXXXXXXXXXXXXXXX-XXXXXXXXXXXXXXXXXXXXXXXXXXXXXXXXX-X-XXXXXXXXXXXXXXXXXXXXXXXXXXXXXXXXXXXXXXXXXXXXXXXXXXXXXXXXXX-XXXXXXXXXXXXXXXXXXXXXXXXXXXXXXXXXXXXXX--XXXXXXXXXXXXXXXXXXX-XX--XXXXXXXXXXXXXXXXXXXX--------XXXXXXXXXXXXXXXXXX