-------------------------------------------------------------------------------------------------------------------------------------------------------------------------------------------------------------------------------------------------------------------------------------------------------------------------------------------------------------------------------------
-------------------------------------------------------------------------------------------------------------------------------------------------------------------------------------------------------------------------------------------------------------------------------------------------------------------------------------------------------------------------------------
-------------------------------------------------------------------------------------------------------------------------------------------------------------------------------------------------------------------------------------------------------------------------------------------------------------------------------------------------------------------------------------
-------------------------------------------------------------------------------------------------------------------------------------------------------------------------------------------------------------------------------------------------------------------------------------------------------------------------------------------------------------------------------------
-------------------------------------------------------------------------------------------------------------------------------------------------------------------------------------------------------------------------------------------------------------------------------------------------------------------------------------------------------------------------------------
-------------------------------------------------------------------------------------------------------------------------------------------------------------------------------------------------------------------------------------------------------------------------------------------------------------------------------------------------------------------------------------
------------------------------------------------------------------------------SSSCSSS---------SSSSSSSCSS-------------------------------------------------------------------------------------------------------------------------------------------------#---------------------------------------------------------------------------------------------------------------------------
------------------------------------------------------------o----------------------------------------------------------------------------------------------------------------------------------------------------------------------------------------------------------------o-------------------------------------------------------------------------------------------------------
------------------------------------------------------------------------------------------------------------------SSSSS----------------------------------------------------o------------------------------------------------------------------------------------SCSSSSSCSSS---------------------------------------S-SS---------------------------------------------------------------
---------------------------------------------------------------------------------------------------------------------------------------------------------------------------o---------------------------------------------------------------------------------#---------------------------------------------------------------------------------------oo------------------------------
------------------------------------------TT-----------------o--------oo-----------o-----------------------TT------------------------------TT----o-------------T-----------------------------------------------TT------------------------------------##------------------------------------------------------------------------------------------------------------TT----------------
------------------------------------TT----TT-----------------------------------o---------------------------TT-----------------------TTT----TT-----------------TT---------------------------TT--------------TT--TT----TT--------------T---------------#-------#---------------------TT------------------------------------------------------------------------------TT----------------
------------------------------------TT----TT---------------------------------------------------------------TT------------------------TT----TT-----------------TT-----T---------------------TT--------------TT--TTT---TT--------------TT------------#-#-------#---------------------TT--------------------------------------------------TT--------------------------TT----------------
----------ggg-----------------------TT----TT----k-------------------------g--------------------------------TT-----------------------kTT----TT-----------------TT-----T------------------gg-T---------------TT--TT----TT---ggg---K----TT----k-------#-#---#---#------------------gg-TT----kk--------------------------------------------TT----T----------------ggg--TT-------ggg------
XXXXXXXXXXXXXXXXXXX-XXXXXXXXXXXXXXXXXXXXXXXXXXXXXXXXXXXXXXXXXXXXXXXXX-XXXXXXXXXXXXXXXXXXXXXXXXXXXXXXXXXXXXXXXX--------X-XXXXXXXXXXXXXXXXXXXXXXXXXXXXXXXXXXXXXXXXXXXX-XX-X-X---XXXXXXXXXXXXXXXXXXXXXXXXXXXXXXXXXXXXXXXXXXXXXXXXXXX-XX-XXXXXXXXXXXXXXX-XXXXXXXXXXXXXXXX--X--XXXXXXXXXXXXXXXXXXXXXXXXXXXXXXXXXXXXXXXXXXXXXXX----XXXX--XXXXXXXXXX--XX--XX--X-XXXXXXXXXXXXXXXXXXXXXXXXXXXX
XXXXXXXXXXXXXXXXXXXXXXXXXXXXXXXXXXXXXXXXXXXXXXXXXXXXXXXXXXXXXXXXXXXX--XXXXXXXXXXXXXXXXXXXXXXXXXXXXXXXXXXXXXXXX--X-----XXXXXXXXXXXXXXXXXXXXXXXXXXXXXXXXXXXXXXXXXXXXXXXXX-X-X---XXXXXXXXXXXXXXXXXXXXXXXXXXXXXXXXXXXXXXXXXXXXXXXXXXXXXXXXXXXXXXXXXXXXXXXXXXXXXXXXXXXXXXX--X--XXXXXXXXXXXXXXXXXXXXXXXXXXXXXXXXXXXXXXXXXXXXXXX----XXXX--XXXXXXXXXX--XX--XX--X-XXXXXXXXXXXXXXXXXXXXXXXXXXXX