-------------------------------------------------------------------------------------------------------------------------------------------------------------------------------------------------------------------------------------------------------------------------------------------------------------------------------------------------------------------------------------
-------------------------------------------------------------------------------------------------------------------------------------------------------------------------------------------------------------------------------------------------------------------------------------------------------------------------------------------------------------------------------------
-------------------------------------------------------------------------------------------------------------------------------------------------------------------------------------------------------------------------------------------------------------------------------------------------------------------------------------------------------------------------------------
-------------------------------------------------------------------------------------------------------------------------------------------------------------------------------------------------------------------------------------------------------------------------------------------------------------------------------------------------------------------------------------
-------------------------------------------------------------------------------------------------------------------------------------------------------------------------------------------------------------------------------------------------------------------------------------------------------------------------------------------------------------------------------------
---------------------------------------------------------------------------------------------------------------------------------------------------------------------------------------------------------------------------------------------------------------------------------------------------------------------------o---------------------------------------------------------
-----------------------------------------------------------------------------------------------------------------------------------------#---SSS-------------------------SSSS--------------------------------------------------------------------------------------------------------------------------------------------------------------------------------------------------------
----------------------------------------------------------------------------------------------------------------------------------------##-------------------------------------------------------------------------------------------------------------------------------------------------------------------------------------------------------------------------------------------
-------SSSCSS--------#-----------------------------------------------------------------------------------------------------------------###-----------------------SSCSS-----------------------------------------------------------------------------------------------------------------------------##--------------------------------------------------------------------------------
--------------------###---------------------------------------------------------------------------------------------------------------####-------------------------------------------------------------------------------o----------------------------------------oo--------------------oo---------##--------------------------------------------------------------------------------
------------------####-------------------------------------------------------------------------------T-------------------------------#####-----------------o-----------------oo------------------------------------------------------------------------------------------------------------------#-#-----------#-------------------------------------------------------TT------------
------------------###-------------------------------------------------------------------------------TT---t--------------------------######-------------T-------------------------------------------------------------------------------t---------------------------------------------------------###-----------#-----------------------------------T-------------------TT----#-------
----------------#-####----------------------------------TT-------------------#--#-------------------TT--tt------------------TT-------#####-------------T----------------------------------------T--------------------------------------TT------------------------------------------------------#-###---------------o-------------------------------T-------------------T-----#---tt--
----------------#-####---------gg-----k-----ggg--TT-----TT----kk---k--g----kk#-k#-----------gg------TT--tt--------ggg--------T-------#-#-#------------TT----g----------------------------------TT---------k-k-------k------------------TT----------------k-------------------------------------#-###---------#------------k------g-k---------------TT----------ggg-------------#-tt--
--XXXXXXXXXXXXXXXXXXXXXXXXXXXXXXXXXXXXXXXXXXXXXXXXXXXXXXXXXXXXXXXXXXXXXXXXXXXXXXX-X-XXXXXXXX---XXXX--X--XXXXXXXXXXXXXXXXXXXXXXXXXXX-XX-XXXXXXXXXXXXXXXXXXXX-XXXXXXX-XXXXXXXXXXXX--X-XX--X-XXXXXXXXXXXXXXXXXXXXXXXXXXXXXXX---XXXXXXXXXXXXXXXXXXXXXXXXXXXXXXXXX-------X----XXX----XXX-XXX----XXXXX-XXXXXXXXXXXXXXXXXXXXXXXXXXXXXXXXXXXXXXXXXXXXXXXXXXXXXX--XXXXXXXXXXXXXXXXXX-XXXX-XXXX
--XXXXXXXXXXXXXXXXXXXXXXXXXXXXXXXXXXXXXXXXXXXXXXXXXXXXXXXXXXXXXXXXXXXXXXXXXXXXXXXXXXXXXXXXX-X--XXXX--X--X-XXXXXXXXXXXXXXXXXXXXXXXXXXXXXXXXXXXXXXXXXXXXXXXXXXXXXXXXX-XXXXXXXXXXXX--X-XX--X-XXXXXXXXXXXXXXXXXXXXXXXXXXXXXXX-X--XXXXXXXXXXXXXXXXXXXXXXXXXXXXXXXX-----X-X----XXX---XXXX-XXX----XXXXXXXXXXXXXXXXXXXXXXXXXXXXXXXXXXXXXXXXXXXXXXXXXXXXXXXXXXXX--XXXXXXXXXXXXXXXXXXXXXXX-XXXX