-------------------------------------------------------------------------------------------------------------------------------------------------------------------------------------------------------------------------------------------------------------------------------------------------------------------------------------------------------------------------------------
-------------------------------------------------------------------------------------------------------------------------------------------------------------------------------------------------------------------------------------------------------------------------------------------------------------------------------------------------------------------------------------
-------------------------------------------------------------------------------------------------------------------------------------------------------------------------------------------------------------------------------------------------------------------------------------------------------------------------------------------------------------------------------------
-------------------------------------------------------------------------------------------------------------------------------------------------------------------------------------------------------------------------------------------------------------------------------------------------------------------------------------------------------------------------------------
-------------------------------------------------------------------------------------------------------------------------------------------------------------------------------------------------------------------------------------------------------------------------------------------------------------------------------------------------------------------------------------
-------------------------------------------------------------------------------------------------------------------------------------------------------------------------------------------------------------------------------------------------------------------------------------------------------------------------------------------------------------------------------------
-------------------------------------------------------------------------------------------------------------------------------------------------------------------------------------ooo---------------------------------------------------------------------------------------------------------------------------------------------------------------------------------------------
---------------------------------------------------------------------------------------------------------------------------------------o------------------------------------------------------------------------------------------------------------oo-------------------------------------------------------------------------------------------------o-----------------------------
-----------------------------------------------------------------------------------------------------------------------------------------------------------------------------------------------------------------------------o---------------------------------------#---------------------------------------------------------------------------------------------------------------
--------oo---------------------------------------------------------------------------------------------------------------------------------------------------------------------------------------------------------SSS-----------------------------------------------#-----------------------------------------------------------------------------------------------o---------------
-----------------------------------------------T------------TT------TT---------------------------TT----------------------------#--------------TT-----TT------------------------T---------------------------------------------------------o-----------------------o---#---##-------------------------T--------------------------oo------------------TT---t----------------------------
----------------------TT----------------------TT------------TT------TT---------------------------TT-------------------------------------------TT-----TT----TT------------------TT----------------------------------------------------------TT--------------------#---#---#-------------------------TT----------------------------------------------TT--tt----------------------------
----------------------TT----------TT-----#----TT------------TT------TT---------------------------TTT--tt---------------------#----------------TT-----TT----TT------------------TT------------------------------------------------------------------------------#-#---#---##------------------------TT----------------------------------------------TT--tt----------------------------
----------------------TT-----ggg--TT---kk#-#--TT----ggg-----TT------TT----------k-k--------------TT---tt--------------kkk--#-#----ggg------g--TT-----TT----TT-----------gg-----TT---------------k-ggg-------k---------------------------------g-g-----ggg------#-#-#-#---##------------ggg-----gg--TT------------gg-----k--------------------------TT--tt--ggg---------------ggg-----
XXXXXXXX--XXXXXXXXXXXXXXXXXXXXXXXXXXXXXXXXXXXXXXXXXXXXXXXXX-XXXXXXXXXXXXXXXXXXXXXXXXXXXX-XX-XXXXXXXXXXXXXXXXXXXXXXXXXXXXXXXXXXXXXXXXXXXXXXXXX-XXXXXXXXXXX-XXXXXXXXXXXXXXXXXXXXXXXXXXXXXXXXXXXXXXXXXXXXXXXXXXXXXXXX----------X-X-XXX-X-XXXXX-XXXXXXXXXXXXXXXXXXXX-XXX-XXX-XXXXXXXXXXXXXXXXXXXXXXXXXXXX-XXXXXXXXXXXXXXXXXXXXXXXXXXXXXXXXX--------XXXXXX--XXXXXXXXXXXX----XXXXXXXXXXXXXX
XXXXXXXX--XXXXXXXXXXXXXXXXXXXXXXXXXXXXXXXXXXXXXXXXXXXXXXXXX-XXXXXXXXXXXXXXXXXXXXXXXXXXXX-X--X-XXXXXXXXXXXXXXXXXXXXXXXXXXXXXXXXXXXXXXXXXXXXXXXXXXXXXXXXXXX-XXXXXXXXXXXXXXXXXXXXXXXXXXXXXXXXXXXXXXXXXXXXXXXXXXXXXXXX--------X-X-X-XX--X-XXXXXXXXXXXXXXXXXXXXXXXXXXXXXXXXXXXXXXXXXXXXXXXXXXXXXXXXXXXXXXX--XXXXXXXXXXXXXXXXXXXXXXXXXXXXXXXX-----X--XXXXXX--XXXXXXXXXXXX----XXXXXXXXXXXXXX