-------------------------------------------------------------------------------------------------------------------------------------------------------------------------------------------------------------------------------------------------------------------------------------------------------------------------------------------------------------------------------------
-------------------------------------------------------------------------------------------------------------------------------------------------------------------------------------------------------------------------------------------------------------------------------------------------------------------------------------------------------------------------------------
-------------------------------------------------------------------------------------------------------------------------------------------------------------------------------------------------------------------------------------------------------------------------------------------------------------------------------------------------------------------------------------
-------------------------------------------------------------------------------------------------------------------------------------------------------------------------------------------------------------------------------------------------------------------------------------------------------------------------------------------------------------------------------------
-------------------------------------------------------------------------------------------------------------------------------------------------------------------------------------------------------------------------------------------------------------------------------------------------------------------------------------------------------------------------------------
-------------------------------------------------------------------------------------------------------------------------------------------------------------------------------------------------------------------------------------------------------------------------------------------------------------------------------------------------------------------------------------
--------------------#--------------------------------------------------------------------------------------------------------------------------------------------ooooo---------------------------------------------------------------------------------------------------------------------------------------------------------------------------------------------------------------
-----------------------------------------------------------------------------------------------------------------------------------------------------------------#-------SSSSS---------------------------------------------------------------o---------------------------------------------------------------------------------------------------------------------------------------
---------------##----------------------------------------------------------------------------------------------------------------------------------o---------oS#-#-------------------------------------------------------------SS----------------------------------------------------------------------------------------------------------------------------------------------------
----------------#--------------------------------------------------------------o---------------------------------------------------------------------------S---------------------------------------------------------------------------------------------------o-----------------------------------------tt-------------o------------------------------------------------------------
------------######-------o-----------------------------------------------------------------T-------------------#---------------#-------------------------------#---------oo----------t-------------------------------------------------------------------------------------------------------------------tt---------TT---------------------------------------------------------------
------------######------------------------------------------------------------------------TT-------------------#---------------------------------------------------------------------t-------------------------------------------------------------------------------------------------------------------tt--------TTT---------------------------------------------------------------
----------#-#-####------------------------------------------------------------------------TT-----------------#-#----------tt---------#-----------------TT------2-----#---------------------------------t---------------------------------------------------------------------------#---------------------ttT-------TT------T-----------------------------#---------------------------
----------#-#---##----------------k---k---------------------------------------------------TT--------------ggg#-#----------tt-------k-#--t--k----k------TT--------K---#---------------k-#---------------t---------------ggg---------------------------------------------------------#---------kk----------ttT-------TT--------------ggg-----ggg-----------#---------------kk----------
----XXXXX-X-XX-XXXXXXXXXXX-XX-X-XXXXXXXXXXXXXXXXXXXXXXXXXXXXX-X-X-XXX-XXXX------------XXXXXXXXXXXXXXXXXXXXXXXXXXXXXXXXXX--XXX-X-XXXXXXXXX-XXXXXXXXXXXX-X-----------XXXXXXXXXXXXXXXXXXXXXXXXXXXXXXXXXX--XX-X-XXXXXXXXXXXXXXXXXXXXXXXXX-X-XXXXXXXXXXXXXXXXXXXXXXX-XXXXX--XX---XXXXXXXXXXX-XXXXXXXXX-----X--XXXXXXXXXXXXXXX----XXXXXXXXXXXXXXXXXXXXXXXXXXXXXXXXXXX--XX--XXXXXXXXXXXXXXXX
------XXXXXXXXXXXXXXXXXXXXXXX-XXXXXXXXXXXXXXXXXXXXXXXXXXXXXXX-X-XXXXX-XXXX--------X---XXXXXXXXXXXXXXXXXXXXXXXXXXXXXXXXXX--XXX-XXXXXXXXXXXXXXXXXXXXXXXXXX-----------XXXXXXXXXXXXXXXXXXXXXXXXXXXXXXXXXX--XX-X-XXXXXXXXXXXXXXXXXXXXXXXXX-X-XXXXXXXXXXXXXXXXXXXXXXX-XXXXXXXXX---XXXXXXXXXXXXXXXXXXXXX-----X--XXXXXXXXXXXXXXX----XXXXXXXXXXXXXXXXXXXXXXXXXXXXXXXXXXX--XX--XXXXXXXXXXXXXXXX