-------------------------------------------------------------------------------------------------------------------------------------------------------------------------------------------------------------------------------------------------------------------------------------------------------------------------------------------------------------------------------------
-------------------------------------------------------------------------------------------------------------------------------------------------------------------------------------------------------------------------------------------------------------------------------------------------------------------------------------------------------------------------------------
-------------------------------------------------------------------------------------------------------------------------------------------------------------------------------------------------------------------------------------------------------------------------------------------------------------------------------------------------------------------------------------
-------------------------------------------------------------------------------------------------------------------------------------------------------------------------------------------------------------------------------------------------------------------------------------------------------------------------------------------------------------------------------------
-------------------------------------------------------------------------------------------------------------------------------------------------------------------------------------------------------------------------------------------------------------------------------------------------------------------------------------------------------------------------------------
-------------------------------------------------------------------------------------------------------------------------------------------------------------------------------------------------------------------------------------------------------------------------------------------------------------------------------------------------------------------------------------
---------------------------------------SSSSCSS-----------------------------------------------------------------------SSSSSS--------#--------oSSCSS-------------------------------------------------------------------------------------------------------------------------------------#-------#-----------------------------------SSSSSS----------------SSSSS-----------------------
-------------------------------------o----------------------------------##-----o--------------------------------------------------##---------------------------------------------------------------------------------------------------------------------------------------------------#------##-------------------------------------------------------------------------------------
------------------------------------------------------------------------##--------------------------------------------------------##----------------------------------------------------------------------------------------------SSS------------------------------------------------##SSCSS-###-------------------------------------------------------------------------------------
------------------------------------------------------------------------##------------------------------------------------------####-------------------------------------------------------------------------------------------------------------------------------------------------##------###-------------------------------------------------------------------------------------
------------------------------------------------oo--------tt------------##-----------------------------TT--------------2---o----####---------oo---------------------TT-----------------------------------------------------------------o-------------------------------------------#--#------##--------------------------------------------------------------oo----------------------
----------------------------------------------------------tt----------#-##-----------------------------TT-----------------------#-##--------------------------------TT---------------------------------------o-------------------------------------------TT------------------------#-#---------#-------------------------------TT-------oo-------------------------------------------
------------------------------------------------------------------------##------------------------------T-----------------------#-##---T----------------------------TT----------------------------------#------------------------#-----------------------TT----------------------#-#-#--------------------------#--------------TT----------------------------------------------------
------------gg----kkk-----kk--------kk----------------------------ggg-#-##------------------------ggg--TT-----k-ggg-------------#-##--TT------------------ggg-------TT------------------k-k---------#-#-#------------------------#-k------k-k------------TT----------------------#-#-##----#----k--------t---------------------TT--gg------------------ggg-------g-----kk------------
----XXXXXXXXXXXXXXXXXXXXXXXXXXXXXXXXXXXXXXX-X-XXXXXXXXXXXXXXXXXXXXXXXXXXXXXXXXXXXXXXXXXXXXXXXXXXXXXXXXXXXXXXXXXXXXXXXXXXXXXXXXXXXXXXXXXXXXXXXXXXXXXXXXXXXXXXXXXXXXXXXXXXXXXXXXXXXXXXXXXXXXXXXXXXX-X-X-X-X-XXXXXXXXXXXXXXXXXXXXXXXXXXXXXXXXXXXXXXXXXXXXXXXXXXXXXXX-XXX-XXXXXXXXXXXX-X-XXXXXXXXXXXXXXXXXX--XXXX-X-XX-XXXXXXXXXXXXXXXXXXXX-X-XX-XXXXXXXXXXXXXXXXXXXXXXXXXXXXXXXXXXXXXXXX
----XXXXXXXXXXXXXXXXXXXXXXXXXXXXXXXXXXXXXXXXXXXXXXXXXXXXXXXXXXXXXXXXXXXXXXXXXXXXXXXXXXXXXXXXXXXXXXXXXXXXXXXXXXXXXXXXXXXXXXXXXXXXXXXXXXXXXXXXXXXXXXXXXXXXXXXXXXXXXXXXXXXXXXXXXXXXXXXXXXXXXXXXXXXXXXXXX-X-XXXXXXXXXXXXXXXXXXXXXXXXXXXXXXXXXXXXXXXXXXXXXXXXXXXXXXXXX-XXXXXXXXXXXXXXXXXXXXXXXXXXXXXXXXXXXXX--XXXXXXXXXXXXXXXXXXXXXXXXXXXXXXXXXXX-XXXXXXXXXXXXXXXXXXXXXXXXXXXXXXXXXXXXXXXX