-------------------------------------------------------------------------------------------------------------------------------------------------------------------------------------------------------------------------------------------------------------------------------------------------------------------------------------------------------------------------------------
-------------------------------------------------------------------------------------------------------------------------------------------------------------------------------------------------------------------------------------------------------------------------------------------------------------------------------------------------------------------------------------
-------------------------------------------------------------------------------------------------------------------------------------------------------------------------------------------------------------------------------------------------------------------------------------------------------------------------------------------------------------------------------------
-------------------------------------------------------------------------------------------------------------------------------------------------------------------------------------------------------------------------------------------------------------------------------------------------------------------------------------------------------------------------------------
-------------------------------------------------------------------------------------------------------------------------------------------------------------------------------------------------------------------------------------------------------------------------------------------------------------------------------------------------------------------------------------
-------------------------------------------------------------------------------------------------------------------------------------------------------------------------------------------------------------------------------------------------------------------------------------------------------------------------------------------------------------------------------------
------------##--------------------------------------------------------------------------------------------------------------------------------------------------------------------------------------------------S---------------------------------------------SSSCSS-----------------------------------------------------------------------------------------------------------------
----------#-##-----------------------------------------------------------------------------------------------------------------------------------------------------------------------------------------------------------------------------------------------------------------------------------------------------------------------------------------------------------------------
----------#-##-------------------------------------------------------------------------------------------------------------------------------------------------------------------------------------------------------------------------------------------------------------------------#---------------------------------------------------------------------------------------------
--------#-####---------------------------------------------------------------------------------------------------------------------------------------------------------------------------------------------------------------------------------------------------------------------------#-------------------------------------------------------------------------------------------
------########----------------##---#-------------------------------------------------------------------TT---TT--------------------------------------TT------------TT---------------------------oo--------#---------oo--------------------------o--------TT-------------------TT----ooo---#----------------------------T----------------o---o-----------------------------------------
------#-######----------------#---##--------------------------------------------------------------------T---TT-------------#------------------------TT------------TT-----------------TT----T-------------#-----#---------o---TT------------------------TTT---tt--------------TT----------#-----------------------------------tt------------------------------------------------gg----
----#-#-######--------------#-#----#--------------------------------------------------------------------T---TT---#---------#---#----#------T--------TT-------------T-----------------TT----TT----------#-------#-------------TT--------------#---#-----TTT---tt--------T-----TT----------#-----------------------------------tt----------#-------------------------------------XXXX-X
ggg-#-#-#-#-##------ggk-k---#-##--##----------------------------kkk---------gg--ggg--------------------TT---TT-kk#--------##-kk#----------TT---gg---TT------------TTT-----k-k--------TT----TT--t-k---------------------------TT-----kk---k---#-kk#-----TT----t-kk------T-----TT----------#--------------------gg------T------tt--------#-#-------g---TT------------ggg-------ggXXXXXX
XXXXX-X-X-X-XXXXXXXXXXXXXXXXXXXXXXXXXXXXXXXXXXXXXXXXXXXXXXXXXXXXXXXXXXXXXXXXXXXXXXXXXXXXXXXXXXXXXXXXXXXXXXXXXXXXXXXXXXXXXXXXXXXXXXX-XX-XXXXXXXXXXXXXXXXXXXXXXXXXXXXXXXXXXXXXX--------XXXXXXXXXXXXXXXXXXXXXXXXXXXXXX-XXXXXXXXXXXXXXXXXXXXXXXXXXXXXXXXXXXTT----XXXXXXXXXXXXXXXXXXXXXXXX----XX--XXXXXXXXXX-XXXXXXXXXXXXXXXXXXX--XX--XXXXXXXXXXXXXXXXXXXXXXXXXXXXXXXXXXXXXXXXXXXXXXXXXXXX
XXXXXXXXXXXXXXXXXXXXXXXXXXXXXXXXXXXXXXXXXXXXXXXXXXXXXXXXXXXXXXXXXXXXXXXXXXXXXXXXXXXXXXXXXXXXXXXXXXXXXXXXXXXXXXXXXXXXXXXXXXXXXXXXXXX-XXXXXXXXXXXXXXXXXXXXXXXXXXXXXXXXXXXXXXXXX-X-X----XXXXXXXXXXXXXXXXXXXXXXXXXXXXXXXXXXXXXXXXXXXXXXXXXXXXXXXXXXXXXXXXXX-T----XXXXXXXXXXXXXXXXXXXXXXXX-X--XX--XXXXXXXXXXXXXXXXXXXXXXXXXXXXXX--XX--XXXXXXXXXXXXXXXXXXXXXXXXXXXXXXXXXXXXXXXXXXXXXXXXXXXX