-------------------------------------------------------------------------------------------------------------------------------------------------------------------------------------------------------------------------------------------------------------------------------------------------------------------------------------------------------------------------------------
-------------------------------------------------------------------------------------------------------------------------------------------------------------------------------------------------------------------------------------------------------------------------------------------------------------------------------------------------------------------------------------
-------------------------------------------------------------------------------------------------------------------------------------------------------------------------------------------------------------------------------------------------------------------------------------------------------------------------------------------------------------------------------------
-------------------------------------------------------------------------------------------------------------------------------------------------------------------------------------------------------------------------------------------------------------------------------------------------------------------------------------------------------------------------------------
-------------------------------------------------------------------------------------------------------------------------------------------------------------------------------------------------------------------------------------------------------------------------------------------------------------------------------------------------------------------------------------
--------tt---------------------------------------------------------------------------------------------------------------------------------------------------------------------------------------------------------------------------------------------------------------------------------------------------------------------------------------------------------------------------
--------tt-------------------------------------------------------------------------------o---------------S-----------------------------------------------------------------------------------------------------------------o-----------oo----oo------------------------------------------------------#---------------##--------------------------------------------------------ooo---
---------t-----------------o---------------------------------o---------------------------------------------------------------------------------------------------------------------------------------------------------------------------------------------#-----------------------------------------#---------------#---------------------------------------------------------------
-------------------------------------------S--------------##-----------------------------------------------------------------------------------------------------------------------------------------------------------------------------------------------#---------t-----------------------------#-#-------------#-#---------------------------------------------------------------
------------------oo--------------------------------------##----------------------------------------------------------------tt-----o-----------------------------------------------------------------------------------------------------------------------#---------tt----------------------------#-#-----------#-------------------------------------------------------------------
----##-------------------------------------------------#####---------------------------#-------------T----------------------tt---------------T-------T-----------------------------------------TT------------------------#-------------------------------#-##----T---t-----------oooo------------#-###---------#-#-------------------------------------------------------------------
----#-------------------------------------------------######--------------------------##------------TT---t-------------------t-----------------------#-----------------------------------------TT------------------------#-------------------------------#-##---TT-------------------------------#####---------#-#-----------T-------------------------------------------------------
--#-#-------------------------------------------------######--------------------------##------------TT--tt----TT-------------------------------------#---------------TT------------#-----------TT--t-------------------#---------------------------------#-#----TT-----------------------------#-#####---------#-#----------TT-------------------------------#-----------------------
--#-#-gg----ggg-------------------------------ggg---#-###-##------#g------k---k-----#-##-----ggg----TT--tt----TT--------------------------ggg------k-#-------g-------TT--------------------ggg-TT--t--k-------------g--#-#--------k-kk-------------------#-#----TT-------------------------ggg-#-#-###---------#-#--k-------TT-----g----------ggg------ggg---#-----------------------
XXXXXXXXXXXXXXXX------XXXX-XX-X-XXXXXXXX----XXXXXXXXX-XXXXXXXXXXX-XXXXXXXXXXXXXXXXXXXXXXXXXXXXXXXXXXXXXXXXXXXXXXX-XXXXXX------X-XX--X-XXXXXXXXXXX-XXXXXXXXXXXXXXXXXXXXXXXXXXXXXXXX-X-XXXXXXXXXXXXXXXX-XX------XXXXX-XXXXXXXXXXXXXXXXXXXXXXXXXXXXXXXXXXXXXXXXXXXXXXXXXXX---XXXXXXXXXXXXXXXXXXXXXX-X-XXXXXXXXXXXXXXXXXXXXXXXXXXXXXXXXXXXXXXXXXXXXXXXX-XXXXXXXXXXXXXXXXXXXXXXXXXXXXXXXXX
XXXXXXXXXXXXXXXX------XXXXXXXXXXXXXXXXXX----XXXXXXXXXXXXXXXXXXXXXXXXXXXXXXXXXXXXXXXXXXXXXXXXXXXXXXXXXXXXXXXXXXXXX-XXXXXX-X------XX--XXXXXXXXXXXXXXXXXXXXXXXXXXXXXXXXXXXXXXXXXXXXXX--XXXXXXXXXXXXXXXXXXXX-----XXXXXXXXXXXXXXXXXXXXXXXXXXXXXXXXXXXXXXXXXXXXXXXXXXXXXXXXXX--XXXXXXXXXXXXXXXXXXXXXXXXXXXXXXXXXXXXXXXXXXXXXXXXXXXXXXXXXXXXXXXXXXXXXXXXXXXXXXXXXXXXXXXXXXXXXXXXXXXXXXXXXXXX