-------------------------------------------------------------------------------------------------------------------------------------------------------------------------------------------------------------------------------------------------------------------------------------------------------------------------------------------------------------------------------------
-------------------------------------------------------------------------------------------------------------------------------------------------------------------------------------------------------------------------------------------------------------------------------------------------------------------------------------------------------------------------------------
-------------------------------------------------------------------------------------------------------------------------------------------------------------------------------------------------------------------------------------------------------------------------------------------------------------------------------------------------------------------------------------
-------------------------------------------------------------------------------------------------------------------------------------------------------------------------------------------------------------------------------------------------------------------------------------------------------------------------------------------------------------------------------------
-------------------------------------------------------------------------------------------------------------------------------------------------------------------------------------------------------------------------------------------------------------------------------------------------------------------------------------------------------------------------------------
-------------------------------------------------------------------------------------------------------------------------------------------------------------------------------------------------------------------------------------------------------------------------------------------------------------------------------------------------------------------------------------
---------------------------------------------------------------------ooo---------------------------oooo---oo-------------------------------------------------------------------------------------------------------------------------------------------------------------------------------------------------------------------------------------------------------------------------
-----------------------------------------------------------------------------------------------------------------------------------------------------------------------------------------------#-------------------------------------------#--------------------------------------------------------------------------------------------------------oo-------------------------------
---------------------------------------------------------------------------------------------------------------------------------------------------------------------------------------------#-#---------SS-S-S----------------------------#---------------------------------------------SSS-----------------------------------------------------------------------------------------
-----------------------------------------------------------------------------------------------------###-----------#-------------------------------------------------------------------------#---------------------------------------------#---------------------------------------------------------------------------------------------o-------------------------------------------
-----------------------------------------------------------------------------------------------------###-------o-###------------------------------------------T----------------------------#-#---------------------------------------------#-----------------------------------#-----------------------------------------------------------------------------------------------------
------------TT----------------TT--------------------------------------------------------------------####--------####---------------------------o---------TT--------------------------------###-------------------------------------#-------#-----------------------------------#-------------------------------------TT--tt--------#----------------------------TT---oo--------------
------TT----TT----------------TT--------------------#----TT----------#------------------------------##-#---------###---------------T---------------#-----TT------------#-----------------#-#-#-----------------TT------------------#---o-#-#-#---------------------------------#--------------------------------------T--tt----TT-------------------------------TT-------------TT--tt
---gg-TT----TT--ggg-------kk--TT------------------gg#----TT-------kk-#--------------------------ggg###-#--------#-##---------ggg---T-------------kk--k---TT---T------k-#-k--k-k---ggg----#-#-#-----------------TT-----k------------#-k-----#-#--------------------k----------#-#-------------------gg-----------------T--tt----TT----------------ggg-------kk---TT-------tt----TT--tt
XXXXXXXXXXXXXXXXXXXXXXXXXXXXXXXXXXX-------------XXXXXXXXXXXXXXXXX-XXXXXXX-XX--X-XX--XX--X-XXXXXXXXXXXXXXXXXXXXX-XXXXXXXXXXXXXXXXXX-X---XXXXXXXXXXXXXXXXXXXX-XXXXXXXXXXXXXXXXXXXXXXXXXXXXXXXX-XXX--------X-X-X-XXXXXXXXXXX-X-XXXXXXXXXXXXXX-XXXXXX-X-X---X-XXXXXXXXXXXXX---XXXXXXXXXXXXXXXX------XXXXXXXXXXXXXXXXXXXXXXXXXXXXXXXXXXXXXXXXX--XXXXXXXXXXXXXXXXXXXXXXXXXXXXXXXXXXXXXXXXXX
XXXXXXXXXXXXXXXXXXXXXXXXXXXXXXXXXXX-------------XXXXXXXXXXXXXXXXXXXXXXXXX-XX--X-XX--XX--XXXXXXXXXXXXXXXXXXXXXXXXXXXXXXXXXXXXXXXXXXXX---XXXXXXXXXXXXXXXXXXXX-XXXXXXXXXXXXXXXXXXXXXXXXXXXXXXXX-XXX------X-X-X-X-XXXXXXXXXXX-X-XXXXXXXXXXXXXXXXXXXXX-X-X---X-XXXXXXXXXXXX----XXXXXXXXXXXXXXXX------XXXXXXXXXXXXXXXXXXXXXXXXXXXXXXXXXXXXXXXXX--XXXXXXXXXXXXXXXXXXXXXXXXXXXXXXXXXXXXXXXXXX