-------------------------------------------------------------------------------------------------------------------------------------------------------------------------------------------------------------------------------------------------------------------------------------------------------------------------------------------------------------------------------------
-------------------------------------------------------------------------------------------------------------------------------------------------------------------------------------------------------------------------------------------------------------------------------------------------------------------------------------------------------------------------------------
-------------------------------------------------------------------------------------------------------------------------------------------------------------------------------------------------------------------------------------------------------------------------------------------------------------------------------------------------------------------------------------
-------------------------------------------------------------------------------------------------------------------------------------------------------------------------------------------------------------------------------------------------------------------------------------------------------------------------------------------------------------------------------------
-------------------------------------------------------------------------------------------------------------------------------------------------------------------------------------------------------------------------------------------------------------------------------------------------------------------------------------------------------------------------------------
-------------------------------------------------------------------------------------------------------------------------------------------------------------------------------------------------------------------------------------------------------------------------------------------------------------------------------------------------------------------------------------
----------------------------o-----SS-----------------------------------------------------------------------------------------------------------------------------------------------------------------------------------------------------------------------------------------------------------------------------------------------------SSSS----------------------SSSS--------------
-------------------------------------------------------------------------------------------------------------------------------------------------------------------------------------------------------------------------------------------------------------o-----------------------------------------------------------------------------------------------------------------------
------------------------------------------------------------------------------------------------SSS-S---------------SSSSSS-------------------------------------------------------------------------------------------------------------------------------------------------------------------------------------------------#o--------------------------------------------------------
-----------------------------------------------------------o-------------------------------------------------------------------------------------------------------------------------------------------------------------------------------------------------------------------------------------------o-----------------------------------------------------------------------------
--------------------#----#--##--oo---o-----------------------------------------------------------------------------------------------------------------------------------------------------o---------------------------------------T-----------------------TT----TTT-----------------------------------------------------#-#---------------------------------------------T-----------
--------------------#------------------------------------------------------------------------------------------------------------------------------------------------------------------------------------------TT------------------TT----------------------TT----TT------------------------TT----------------------------#-#-------------#--------------------------------T----------
----------T-------#-######---------------------------------------------------------------------------------------T-------------TT--------------------------------T--------------------------------------#-#----TT------------------TT----------------------TT----TT------------------------TT--------------------------#---#-------------#-----------------------#--------T----------
------------gg------#-#-------------k---------k-k-ggg-----------ggg---------kk----------------------------------kT-------------TT-----kkk-----ggg----------------T---kkk-------------------------gg-----#-#----TT----------k---#---TT------ggg-----ggg-----TT----TT------k-gg-----k-----gg-TT----kk--------------------#-###---------ggg-#---------------ggg-----T---k---TT----ggg---
XXXXXXXXXXXXXXXXXXX-X-X---XXXXXXXXXXXXXXXXXXXXXXXXXXXXXXXXXXXXXXXXXXXXXXXXXXXXXXX---XXXXXXXXXXXXXXXXXXXXXXXXXXXXXXXXXX--X-XXXXXXXXXXXXXXXXXXXXXXXXXXXXXXX-X-XXXXXXXXXXXXXXXXXXXXXXXXXXXXXXXXXXXXXXXXXXX-X-X--X-XX---XXXXXXXXXXXXXXXXX--XXXXXXXXXXXXXXXXXXXXXXXXXXXXXXXXXXXXXXXXXXXXXXXXXXXXXXXXXXXXX-XX---X---X--XXXXXX--XXXXXXXXXXXXXXXXXXXX--X-X-XX-XXXXXXXXXX-XXXXXXX-XX--XXXXXXXX
XXXXXXXXXXXXXXXXXXXXXXXXXXXXXXXXXXXXXXXXXXXXXXXXXXXXXXXXXXXXXXXXXXXXXXXXXXXXXXXXX---XXXXXXXXXXXXXXXXXXXXXXXXXXXXXXXXXX--X-XXXXXXXXXXXXXXXXXXXXXXXXXXXXXXX-XXXXXXXXXXXXXXXXXXXXXXXXXXXXXXXXXXXXXXXXXXXXX-X-X-XXXXX---XXXXXXXXXXXXXXXXX--XXXXXXXXXXXXXXXXXXXXXXXXXXXXXXXXXXXXXXXXXXXXXXXXXXXXXXXXXXXXXXXX---X---X--XXXXXX--XXXXXXXXXXXXXXXXXXXX--X-X-XX-XXXXXXXXXXXXXXXXXXXXX--XXXXXXXX