----------------------------------------------------------------------------------------------------------------------------------------------------------------------------------------------------
----------------------------------------------------------------------------------------------------------------------------------------------------------------------------------------------------
----------------------------------------------------------------------------------------------------------------------------------------------------------------------------------------------------
----------------------------------------------------------------------------------------------------------------------------------------------------------------------------------------------------
------------------------------------SSS-------------------------------------------------------------------------------------------------------------------------------------------------------------
----------------------------k-----------------------k-----------------------------------------------------------------------------------------------------------------------------------------------
-------------------SSS----SSSS-----------Q--SQ------Q------------------------------------------SS--------------------------------SSSSSS-----------------------------------------SQSSQS--------------
----------------------------------------------------#-------------------------------------------#---------------------------------------------------------------------------------------------------
-------------------------------SSS-SSSS------------##---------------------SQ-------------------g#--------------------S-S----------------------------------------------------------------------------
--------------------------------------------------##----------------#--------------------------g#----------------------------------K----------------------------------------------------------------
-------------SSS--SSSS----#--------------SSS-----##-----SS------#---##------------TT---------####---------S--------------------##-----------#-#--------------SS------#------TT--SQSSQS----SS----#---
--------------------------#---------------------####------------#---##------------TT---------#--#-----------------------------#------------##-----------------------##------TT----------------------
--------------------------#--------------------####------------##---##------------TT------------#-------------------TT-------------------####----------------------###------TT----------------------
-------------------------g#-------------------#####-----K---K-#-#---##----------ggTT------------#-------ggT---------T---gg---------------###--K-------------------####------TT----------------------
XXXXXXXXXXXXXXXXXXXXXXXXXXX---XXXXXXXXXXXXXXXXXXXXXXXXXXXXXXXXXXXXXXXX-XXXXXXXXXXXXXXXXXX-----------XXXXXXXXXXXXXXXXXXXXXXXXXXXXX----XXXXXXXXXXXXXXXXXXXXXXXXXXXXXXXXXXXXXXXXXXXXXXXX---------------
XXXXXXXXXXXXXXXXXXXXXXXXXXX---XXXXXXXXXXXXXXXXXXXXXXXXXXXXXXXXXXXXXXXXXXXXXXXXXXXXXXXXXXXX----------XXXXXXXXXXXXXXXXXXXXXXXXXXXXX----XXXXXXXXXXXXXXXXXXXXXXXXXXXXXXXXXXXXXXXXXXXXXXXX---------------