----------------------------------------------------------------------------------------------------------------------------------------------------------------------------------------------------
----------------------------------------------------------------------------------------------------------------------------------------------------------------------------------------------------
----------------------------------------------------------------------------------------------------------------------------------------------------------------------------------------------------
----------------------------------------------------------------------------------------------------------------------------------------------------------------------------------------------------
----------------------------------------------------------------------------------------------------------------------------------------------------------------------------------------------------
--------------------------------------------------------------------------------k-------------------------------k-----------------------------------------------------------------------------------
--------SSSS-------------------------------------------------SSSSSS----####----SQS---------------------S-SSS---SSS--------------------------SS-S-------------------------------------S--------------
----------------------------------------------------------------------------------------------------------------------------------------------------------------------------------------------------
---------------------------------------------------------------------------------------------------------------------------------S--#---------------------------------------------------------------
------------------------------------------------------------------------------------------------------------------------------------##----------------------------#---------------------------------
-----#---SSS--------------S-------------SSSSSSSS--------------SSSS------------------------------------------#----##------SSSS------###------SS--SS-S-------------##------------Q------#---------TT--
----------------------------------------------------------------------##------------TT----------------------#----------------------###--------------------------###-------------------#---------TT--
----------------------------------------------------------------------##--------T---TT----------------------#----#----------------####-------------------------####------------------##-------------
-----------g--------------------------------------------------------gg#---------k---TT------k-------gg------#----#----------------####----------gg--------K---#####-----------------###-------gg-#--
XXXXX---XXXXXXXXXXXXXXXXXXXXXXXXXXXXXXXXXXXXXXXXXXXXXXXX-----XXXXXXXXXX---XXXXXXXXXXXXXXXXXXXXXXXXXXXXXXXXXXX---XXXXXXXXXXXXXXXXXXXXXXXXXXXXXXXXXXXXXXXXXXXXXXXXXXXXXXXXXXXXXXXXXXXXXXX--XXXXXXXXXXX
XXXXX---XXXXXXXXXXXXXXXXXXXXXXXXXXXXXXXXXXXXXXXXXXXXXXXX-----XXXXXXXXXX---XXXXXXXXXXXXXXXXXXXXXXXXXXXXXXXXXXXX--XXXXXXXXXXXXXXXXXXXXXXXXXXXXXXXXXXXXXXXXXXXXXXXXXXXXXXXXXXXXXXXXXXXXXXX--XXXXXXXXXXX