----------------------------------------------------------------------------------------------------------------------------------------------------------------------------------------------------
----------------------------------------------------------------------------------------------------------------------------------------------------------------------------------------------------
----------------------------------------------------------------------------------------------------------------------------------------------------------------------------------------------------
----------------------------------------------------------------------------------------------------------------------------------------------------------------------------------------------------
----------------------------------------------------------------------------------------------------------------------------------------------------------------------------------------------------
----------------------------------------------k-----------------------------------------------------------------------------------------------------------------------------------------------------
---------------------------------------------S-S------------------------SQSS-SSS-------SS--------------------------------SS-----------SSSSS-----------------------------------------------#---------
----------------------------------------------------------------------------------------------------------------------------------------------------------------------------------------------------
--------------------------------------------#----------------------------------------------------------------------------------------------------------------------------------------------S-S------
------#-------------------------------------#-------------------------------------------g#--------------------------------------------------------------------------k-----gg------------#-----------
------#--------SCS----------#--------------##---------T-----------------SSSSSSSSS----#####--------SSQS-------------------SQS---------SSSSSS-------------SSS--------S#-######-----------###----------
------#-TT-----------------##-------TT----###-------TT---------------------------------###--------------------------------------------------------------------------------------------####----------
--------TT------------------#-------TT---####-------TT--------------#----------------#####----------TT----TT-------------------------------------------------------------------------#####----------
--------TT-----T------k-----#----g--TT--#####-----k-TT------------------------gg----#####-------ggg-TT--k-TTk---------T------------------------------------------------------------#######-------#--
XXXXXXXXXXXXXXXXXXXXXXXXXXXXX-XXXXXXXXXXXXXXXX-XXXXXXXXXXXXXXX----XXXXXXXXXXXXXXXXXXXXXX--XX-XXXXXXXXXXXXXXXXXXXXXXXXXXXXXXXXXXXXXXXXXXXXXXXXXXXXXXXXXXXXXXXXXXXXXX------------XXXXXXXXXXXXXXXXXXXXX
XXXXXXXXXXXXXXXXXXXXXXXXXXXXXXXXXXXXXXXXXXXXXXXXXXXXXXXXXXXXXX----XXXXXXXXXXXXXXXXXXXXXX--XX-XXXXXXXXXXXXXXXXXXXXXXXXXXXXXXXXXXXXXXXXXXXXXXXXXXXXXXXXXXXXXXXXXXXXXX------------XXXXXXXXXXXXXXXXXXXXX