----------------------------------------------------------------------------------------------------------------------------------------------------------------------------------------------------
----------------------------------------------------------------------------------------------------------------------------------------------------------------------------------------------------
----------------------------------------------------------------------------------------------------------------------------------------------------------------------------------------------------
----------------------------------------------------------------------------------------------------------------------------------------------------------------------------------------------------
----------------------------------------------------------------------------------------------------------------------------------------------------------------------------------------------------
----------------------------------------------------------------------------------------------------------------------------------------k-----------------------------------------------------------
---------------------------------------------------------------------------------------------------------------------S-S---------------SQS----SS----------------------------------------------------
----------------------------------------------------------------------------------------------------------------------------------------------------------------------------------------------------
------------------------------------------------------S-------------------------------#--------SQS-SSS------------------------------------------------------------------------SS--------------------
------------------------------------------------#------------------------------------##---------------#-------------------------------------------ggg-----------------------------------------------
----#--------------------------#--------------###------------------------------########---------------#-------------S-----------------------#-#######---------------#####---------------------------
------------TT----------------##----------------#-----------------------------#-########-------------##-------------#-----------------------#-------#---------T-------------------------------------
------------TT---------------###------------#--------------------------------###########-----------#-##-------------#--------T--------------#---------------TT----------#---#---------T-------------
--------ggg-TT--gg----------#-##----------------#--------------------------#############-----------####-------------#-------T---gg----------#------------g--TT----------#---#---------T---k---K-----
---XXXXXXXXXXXXXXXXXXXXXXXXXXXXXXXXXXXXXXXXXXXXXXXXXXXXXXXXXXXXXXXXXXXXXXXXXXXXXXXXXXXXXXXXXXXXXXXXXXXX--XXXXXXXXXXXX---XXXXXXXXXXXX---X-XXXXX-----------XXXXXXXXXXXXXXXX---XX--XXXXXXXXXXXXXXXX----
---XXXXXXXXXXXXXXXXXXXXXXXXXXXXXXXXXXXXXXXXXXXXXXXXXXXXXXXXXXXXXXXXXXXXXXXXXXXXXXXXXXXXXXXXXXXXXXXXXXXX--XXXXXXXXXXXX---XXXXXXXXXXXX--XXXXXXX------------XXXXXXXXXXXXXXXX---XX--XXXXXXXXXXXXXXXX----