----------------------------------------------------------------------------------------------------------------------------------------------------------------------------------------------------
----------------------------------------------------------------------------------------------------------------------------------------------------------------------------------------------------
----------------------------------------------------------------------------------------------------------------------------------------------------------------------------------------------------
----------------------------------------------------------------------------------------------------------------------------------------------------------------------------------------------------
----------------------------------------------------------------------------------------------------------------------------------------------------------------------------------------------------
----------------------------------------------------------------------------------------------------------------------------------------------------------------------------------------------------
-----------------------------Q--------------SSSSSS---------SQS------SS?SSS---------------##-------------------------#-----------------------------------------------------------SQS-----------------
----------------------------------------------------------------------------------------###------------------------##-------------------------------------------------------------------------------
----------------------------------#---------------------------------------------------g####----------------------####------------------------------SQS----------------------------------------------
----------------------------------#--------------------------------------------------g#####---------------------#####-----------------------------#-------------------------------------------------
------------SSCSSS------S?SSQS---##--------SSSSSSSSSSSSS-SSSSSSS--SSSSSSSSSSSS-S-----######-------SSCS--TT-----######--S-------------------------g#-------TT----TT-------S-----S-SSSSS----------TT--
--------------------------------###-------------------------------------------------#######----------K--TT----#######---------------------------###--------T----TT----T-------------------TT----TT--
--------------------------------###-------------------------------------TT----------#######-------------TT---########--------------------T------####------------TT----TT------------------TT----TT--
------gg----------ggg-------------#-----k-------------K-------K---K-g---TT---------########--------K----TT--#########--------------------T-----####---k---------TT--k-TT------------------TT--ggTT--
---XXXXXXXXXXXXXXXXXXXXXXXXXXXXXXXXXXXXXXXXXXXXXXXXXXXXXXXXXXXXXXXXXXXXXXXXXXXXXXXXXXXXXXXXXXXXXXXXXXXXXXXXXXXXXXXXXXXXXXXXXXXXXXXXXXXXXXXXXXXXXXXXXXXXXXXXXXXXXXXXXXXXXXXXXXXXXXXXXXXXXXXXXXXXXXXXX
---XXXXXXXXXXXXXXXXXXXXXXXXXXXXXXXXXXXXXXXXXXXXXXXXXXXXXXXXXXXXXXXXXXXXXXXXXXXXXXXXXXXXXXXXXXXXXXXXXXXXXXXXXXXXXXXXXXXXXXXXXXXXXXXXXXXXXXXXXXXXXXXXXXXXXXXXXXXXXXXXXXXXXXXXXXXXXXXXXXXXXXXXXXXXXXXXX