----------------------------------------------------------------------------------------------------------------------------------------------------------------------------------------------------
----------------------------------------------------------------------------------------------------------------------------------------------------------------------------------------------------
----------------------------------------------------------------------------------------------------------------------------------------------------------------------------------------------------
----------------------------------------------------------------------------------------------------------------------------------------------------------------------------------------------------
----------------------------------------------------------------------------------------------------------------------------------------------------------------------------------------------------
----------------------------------------------------------------------------------------------------------------------------------------------------------------k-----------------------------------
------------------------------------S?SS----------------------------------------#----------------#------------------------------------------------------------SQSS-S------------------------SSQSS---
--------------------------------------------------------------------------------#---#-----------##--------------------------k-----------------------------------------------------------------------
---------------------Q----------------------------------------------SSSS--------##--#-----------##-----------------------SCS-S----------------------------------------------------------------------
----------------------------------------S----------------------###--------------##--#-----------###------------------------K-----------------T------------------------------------------------------
-----------S-------------------T------------------------------####-------------###--#----T-----####------SSSS-----------S-------------------TT--------------SSSSSSS----T---------------------SSSS---
------------------------------TT------------------TT--------######------------###---#----T-----####--------------TT------K----------K-------TT--#----------------------T----------------------------
------------------------------TT------------------TT-------#######-----------####---#--------#-####--------------TT-------------------------TT--#----------------------TT------------##-------------
----------TT----------------ggTT----------------ggTT------########----------#####---#--------#-####-------gggggg-TT---------------------T---TT--k---k-------------K---gTT---k---k-------------------
-------XXXXXXXXXXXXXXXXXXXXXXXXXXXXXXXXXXXXXXXXXXXXXXXXXXXXXXXXXXXXXXXXXXXXXXXXXX---XXXXXXXXXXXXXXX----XXXXXXXXXXXXXXXXXXXXXXXXXXXXXXXXXXXXXXXXXXXXXXXXXXXXXXXXXXXXXXXXXXXXXXXXXXXXXXXXXXXXXXXXXXX--
-------XXXXXXXXXXXXXXXXXXXXXXXXXXXXXXXXXXXXXXXXXXXXXXXXXXXXXXXXXXXXXXXXXXXXXXXXXX---XXXXXXXXXXXXXXX---XXXXXXXXXXXXXXXXXXXXXXXXXXXXXXXXXXXXXXXXXXXXXXXXXXXXXXXXXXXXXXXXXXXXXXXXXXXXXXXXXXXXXXXXXXXX--