----------------------------------------------------------------------------------------------------------------------------------------------------------------------------------------------------
----------------------------------------------------------------------------------------------------------------------------------------------------------------------------------------------------
----------------------------------------------------------------------------------------------------------------------------------------------------------------------------------------------------
----------------------------------------------------------------------------------------------------------------------------------------------------------------------------------------------------
----------------------------------------------------------------------------------------------------------------------------------------------------------------------------------------------------
------------------------------------------------------------------------k---------------k-----------------------------------#-----------------------------------------------------------------------
-------------------------SS-----------SQSS---------SQS-----------------SQS--------------Q--------------------------------gg###--------------------------SS----------------SQ--SS--SQ----------------
-------------------------------------------------------------------------K-----------------------------------------------#####--------------------#-------------------------------------------------
----------------------------------------------SQS--------------------------------SQS-SSS----SQS-----#-----#-------------######-------------------g#-------------------------------------------------
----k----------------------------------------------------------------------------------------------g#-----#------------#######------------------g##-------------------------------------------------
----QS--SSS--------------SSSS--------SSSSS----------#----S-------S----SSS---------------#-----------#-----#-----------########---------------##-###---SSSS----------TT--------SS--SSSSS-------------
--------------------#---------------------------#---------------------------------------#-----------#-----#---TT------########--------------#---###-----------------TT---------------------T--------
--------------------#-------------------------------#-----------------------------------#-----------#-----#---TT---#-####-####------TT-----##--####-----------------TT---------------------TT-------
--------ggk---k---#-#-------K-----------------------#----------------gTT----------------#-----------#---#-----TT--######--####-----gTT---#####-####-------------k--gTT--------------K---gg-TT----#--
XXXXXXXXXXX---XXXXXXXXXXXXXXXXXXXXXXXXXXXXXXXXXXXXXXXXXXXXXXXXXXXXXXXXXXXXXXXXXXXXXXXXXXXXXXXXXXXXXXX---XXXXXXXXXXXXXXXXXXXXXXXXXXXXXXXXXXXXXXXXXXX---XXXXXXXXXXXXXXXXXXXXXXXXXXXXXXXXXXXXXXXXXXXXXX
XXXXXXXXXXX---XXXXXXXXXXXXXXXXXXXXXXXXXXXXXXXXXXXXXXXXXXXXXXXXXXXXXXXXXXXXXXXXXXXXXXXXXXXXXXXXXXXXXXX---XXXXXXXXXXXXXXXX--XXXXXXXXXXXXXXXXXXXXXXXXX---XXXXXXXXXXXXXXXXXXXXXXXXXXXXXXXXXXXXXXXXXXXXXX