----------------------------------------------------------------------------------------------------------------------------------------------------------------------------------------------------
----------------------------------------------------------------------------------------------------------------------------------------------------------------------------------------------------
----------------------------------------------------------------------------------------------------------------------------------------------------------------------------------------------------
----------------------------------------------------------------------------------------------------------------------------------------------------------------------------------------------------
----------------------------------------------------------------------------------------------------------------------------------------------------------------------------------------------------
----------------------------------------------------------------------------------k-----------------------------------------------------------------------------------------------------------------
--------------------------------------#---#---------------------------SSQSSSSSSSSSSS--------------------------------------------------------------------SSS---------??SSSSSSSS?S--------------------
----------------------#---------------#-------------------------------------------------------------------------------------------------------------------------gg#---------------------------------
---------------------##-------------------#----------SSSSSSSS------------------------S---------------------------------------------------------------------------##---------------------------------
----------------------#-------------------#---------------------------------------------------------------------------------k-----------------------------------###---------------------------------
-------------------##-#-------TT-------####----------#----------------SSSSSSSSSSS-S--------S--S------------------------TT--SQS--SSS----S------------------S-----###---SSSSSSSSS----------T----------
-----------------###--#-------TT------#####--------####------------#----------------------------------TT-----T----------T--------------K-----------------------####----------------------T----------
--------TT-------##---#-------TT------#####-------#####-----------------------------------------------TTT---TT-------------------------------------------------#####---------------------TT---------
----gg--TT------##----#---k---TT-----######------######-------k---------------K-------------------k--g-TT---TT----gg----TT----------k-------------------------#####-----------k----------TT------#--
--XXXXXXXXXXXXXXXXXXXXXXXXXXXXXXXXXXXXXXXXX---XXXXXXXXX--XXXXXXXXXXXXXXXXXXXXXXXXXXXXXXXXXXXXXXXXXXXXXXXXXXXXXXXXXXXXXXXXXXXXXXXXXXXXXXXXXXXX---------X----XXXXXXXXXXXXXXXXXXXXXXXXXXXXXXXXXXXXXXXXX
--XXXXXXXXXXXXXXXXXXXXXXXXXXXXXXXXXXXXXXXXX---XXXXXXXXX--XXXXXXXXXXXXXXXXXXXXXXXXXXXXXXXXXXXXXXXXXXXXXXXXXXXXXXXXXXXXXXXXXXXXXXXXXXXXXXXXXXXX---------X----XXXXXXXXXXXXXXXXXXXXXXXXXXXXXXXXXXXXXXXXX