----------------------------------------------------------------------------------------------------------------------------------------------------------------------------------------------------
----------------------------------------------------------------------------------------------------------------------------------------------------------------------------------------------------
----------------------------------------------------------------------------------------------------------------------------------------------------------------------------------------------------
----------------------------------------------------------------------------------------------------------------------------------------------------------------------------------------------------
----------------------------------------------------------------------------------------------------------------------------------------------------------------------------------------------------
----------------------------------------------------------------------------------------------------------------------------------------------------------------------------------------------------
-----------------------------SCS---------------------------------------S------------------S---------------------###------------------------------------SQ-------------------------------------------
-------------------------------K--------------------------------------------------------------------------------###--------SSS----------------------------------------------------------------------
-----------------------------------------------------------------------------QSSSSS-----------SSS------------######-------##----#------SSS-S--------------SSSSQS------------------------------------
----------------------------------------------------------------------##-------------------------------------######------###----#-------------#-----------------------------------------------------
---------TT---------S-S---------SSSSCS----TT------------------TT-----###------------------------------------#######-----####----#-------------#------------------------------SSS--------------------
---------TT-----------------#--------K----TT------------------TT----###-----------------------##--------#-----#####----#####----------------###-------------------------------------------TT--------
---------TTT----------TT----#-----------------------TT--------TT---####----------------------###--------#-----#####---######----------------###-------------------------------------------TT--------
--------gTT-----------TT----#------K-----gg---------TT----k-ggTT---####---------------------####--------#-----#####---######---------------####-------------ggg-------------k-----------ggTT-----#--
XXXXXXXXXXXXXXXXXXXXXXXXXXXXXXXXXXXXXXXXXXXXXXXXXXXXXXXXXXXXXXXXXXXXXXXX--XXXXXXXXXXXXXXXXXXXXXXXXXXXXXXX-----XXXXX-XXXXXXXX--X----XXXXXXXXXXXX-XXXXXXXX--XXXXXXXXXXXXXXXXXXXXXXXXXXXXXXXXXXXXXXXXXX
XXXXXXXXXXXXXXXXXXXXXXXXXXXXXXXXXXXXXXXXXXXXXXXXXXXXXXXXXXXXXXXXXXXXXXXX--XXXXXXXXXXXXXXXXXXXXXXXXXXXXXXX-----XXXXX-XXXXXXXX--X----XXXXXXXXXXXX-XXXXXXXX--XXXXXXXXXXXXXXXXXXXXXXXXXXXXXXXXXXXXXXXXXX