----------------------------------------------------------------------------------------------------------------------------------------------------------------------------------------------------
----------------------------------------------------------------------------------------------------------------------------------------------------------------------------------------------------
----------------------------------------------------------------------------------------------------------------------------------------------------------------------------------------------------
----------------------------------------------------------------------------------------------------------------------------------------------------------------------------------------------------
----------------------------------------------------------------------------------------------------------------------------------------------------------------------------------------------------
----------------------k-----------------k-----------------------------------------------------------------------------------------------------------------------------------------------------------
-------Q-----------------------------SCSSS-------------------------SCSSS-----------------------------------------------------------------------------------------------------QSSSS------------------
---------------------------------------K-----------------------------K----------------------------------------------------------------------------k-------------------------------------------------
-------------------------------------------------------------------------------------------------SQS-------------------Q-------------------------##-------------QSSS--------------------------------
-------------------------------------K-----------------------------------------gggg--------gg---------------------------------------------------g###------------------------------------------------
---------SSS--S-----------#-------##--SSSSSS------------TT------#-------------#####-----#####------------------#---------------------------#########------SS-----------------SSSSS-------TT---------
--------------------------#-------##----------------TT--TT------#---------------------------------------------##--------------------------##----####------------------TT-----------------TT---------
---------------T----------#-------#-----------------TT---T---------------------------------------------------###-------------------------###-----###------------------TT------------------T---------
--------k-----TT------k---#-----#-#--------ggg------TT---T--------------------------------------------------####------K-----------k-----####-----###--------K---------TT--------------gg-TT---------
-XXXXXXXXXXXXXXXXXXXXXXXXXX-----XXXXXX-XXXXXXXXXXXXXXXXXXXXXXX--XXXXXXXXXXXX---------------------XXXXXXXXXXXXXXX--XXXXXXXXXXXXXXXXXXXXXXXXXXX---XXXXXXXXXXXXXXXXXXXXXXXXXXXXXXXXXXXXXXXXXXXXXXXXXX--
--XXXXXXXXXXXXXXXXXXXXXXXXX-----XXXXXX--XXXXXXXXXXXXXXXXXXXXXX--XXXXXXXXXXXX---------------------XXXXXXXXXXXXXXX--XXXXXXXXXXXXXXXXXXXXXXXXXX----XXXXXXXXXXXXXXXXXXXXXXXXXXXXXXXXXXXXXXXXXXXXXXXXXX--