--------------------------------------------------------------------------------------------------------------------------------------------------------------------------------
--------------------------------------------------------------------------------------------------------------------------------------------------------------------------------
--------------------------------------------------------------------------------------------------------------------------------------------------------------------------------
--------------------------------------------------------------------------------------------------------------------------------------------------------------------------------
-----------------------------------------------------------------------------------------------------------------------------------------------------#--------------------------
----------------------------------------------------------------------------------------------------------------------------------------------------#---------------------------
-----------------------------------------------------------------------------S-------#------------SS---------------------------SSS----------------SS##-------------##-----------
----------K-------------------------------------------------------------------------##----------------------------------------------------------------------------###-----------
---------------------------------------------------------##------------------------###---------------------------##----------------------------------------------###------------
--------------------------------------------------------###-----------------------####--------------------------###------------K--------------------------------####------------
--------SSSS-------------------------------------------####----SS#-S-------------#####--SS--------S--S---------#####----------SSSS-----------------------------#####------------
---------------------------#--------------------------#####---------------------######-------*-------K--------######---------------*---------*----------------######------------
---------------------------#---*-----*-----*-----T---######---------TT---------#######-------*-----------*---#######----TT---------*---------*---TT----------#######------------
-------------------------------*-----*-----*-----T---#######--------TT--------#######--------#-----------#--########----TT---------*---------B---TT---------########------------
XXXXXXXXXXXXXXXXXXXXXXXXXXXXXXXXXXXXXXXXXXXXXX------XXXXXXXXXXXXXXXXXXXXXXXXXXXXXXXXXXXXXXXXXXXXXXXXXXXXXXXXXXXXXXXXXXXXXXXXXXXXXXXXXXXXXXXXXXXXXXXXXXXXXXX-XXXXXXXXXXXXXXXXXXXX
-XXXXXXXXXXXXXXXXXXXXXXXXXXXXXXXXXXXXXXXXXXXXX--------XXXXXXXXXXXXXXXXXXXXXXXXXXXXXXXXXXXXXXXXXXXXXXXXXXXXXXXXXXXXXXXXXXXXXXXXXXXXXXXXXXXXXXXXXXXXXXXXXXXXX-XXXXXXXXXXXXXXXXXXXX