--------------------------------------------------------------------------------------------------------------------------------------------------------------------------------
--------------------------------------------------------------------------------------------------------------------------------------------------------------------------------
--------------------------------------------------------------------------------------------------------------------------------------------------------------------------------
--------------------------------------------------------------------------------------------------------------------------------------------------------------------------------
--------------------------------------------------------------------------------------------------------------------------------------------------------------------------------
--------------------------------------------------K-----------------------------------------------------------------------------------------------------------------------------
-----------S--------S---------------------------SSSS-------------------------------SSS------------------SSS---------SS------SSSSSSSS--------------SSSSSS------------------------
---------------------K-------------------------------------K----------------K---------------------------------------------------------------------------------------------------
----------------------------------------------------------------------------K---------------------------------------------------------------------------------------------------
---------*-------------------------------------K-------------------------------------------------------------------------------*------------------------------------------------
--------SSCS----------------------------------SSSSSS----------------------------S----#-------SSSS---------------------------SSS#SS---------------SSSSSSS------------------------
-------------*-------------------*-------T-------------*-------*---------------------#--------------T-------------------------------------TT---------------#--------------------
-------------*-------------#-----*-------TT------------*-------*---*-----------------#-----------------------------*----------------------TT---------------------------*--------
-------------B-------#-----#-----B-------TT------------*-------*---*-----------------#-----------------------------*----------------------TT---------------------------*--------
XXXXXXXXXXXXXXXXXXXXXXXXXXXXXXXXXXXXXXXXXXXXXXXXXXXXXXXXXXXXXXXXXXXXXXXXXXXXXXXXXXXXXXXXXXXXXXXXXXXXXXXXXXXXXXXXXXXXXXXXXXXXXXXXXXXXXXXXXXXXXXXXXXXXXXXXXXXXXXXXXXXXXXXXXXXXXXXX
XXXXXXXXXXXXXXXXXXXXXXXXXXXXXXXXXXXXXXXXXXXXXXXXXXXXXXXXXXXXXXXXXXXXXXXXXXXXXXXXXXXXXXXXXXXXXXXXXXXXXXXXXXXXXXXXXXXXXXXXXXXXXXXXXXXXXXXXXXXXXXXXXXXXXXXXXXXXXXXXXXXXXXXXXXXXXXXX