--------------------------------------------------------------------------------------------------------------------------------------------------------------------------------
--------------------------------------------------------------------------------------------------------------------------------------------------------------------------------
--------------------------------------------------------------------------------------------------------------------------------------------------------------------------------
---------#----------------------------------------------------------------------------------------------------------------------------------------------------------------------
--------##-------------------------------------------------------------------------#--------------------------------------------------------------------------------------------
-------###------------------------------------------------------------------------#---------------------------------------------------------------------------------------------
------####----------------------S---------------------S-------------------------SSSS--------------------------------------------------------------------------------------------
------#####---------------------------------------------------------------------------------------------------------------------------------------------------------------------
------######-------------SSSSS-------------*-----------------------------------------------------S---------S--------------------------------------------------------------------
------######-------------------------------*---------*--------------------------------------------------------------------------------------------------------------------------
------######-----------------------------SS#CS------Q#----------------------SSS#SS-----------------------------------SSSS-------------------------SSS---------SSSS-----#--------
-----#######-------------------------------------------------------K---*-------------------K---*------TT-------------------------*------------TT----------------------##--------
----########---*---T-------------*-------------*---------*-------------*-----------------------*-----*----------TT-----T---------*-------*----TT---------------------###--------
---#########---*---T-------------*-------------*-----------------------B-----------------------B-----B----------TT---------------B-------*----TT--------------------####--------
XXXXXXXXXXXXXXXXXXXXXXXXXXXXXXXXXXXXXXXXXXXXXXXXXXXXXXXXXXXXXXXXXXXXXXXXXXXXXXXXXXXXXXXXXXXXXXXXXXXXXXXXXXXXXXXXXXXXXXXXXXXXXXXXXXXXXXXXXXXXXXXXXXXXXXXXXXXXXXXXXXXXXXXXXXXXXXXX
XXXXXXXXXXXXXXXXXXXXXXXXXXXXXXXXXXXXXXXXXXXXXXXXXXXXXXXXXXXXXXXXXXXXXXXXXXXXXXXXXXXXXXXXXXXXXXXXXXXXXXXXXXXXXXXXXXXXXXXXXXXXXXXXXXXXXXXXXXXXXXXXXXXXXXXXXXXXXXXXXXXXXXXXXXXXXXXX