--------------------------------------------------------------------------------------------------------------------------------------------------------------------------------
--------------------------------------------------------------------------------------------------------------------------------------------------------------------------------
--------------------------------------------------------------------------------------------------------------------------------------------------------------------------------
--------------------------------------------------------------------------------------------------------------------------------------------------------------------------------
--------------------------------------------------------------------------------------------------------------------------------------------------------------------------------
-------------------------------------------------------------------------K------------------------------------------------------------------------------------------------------
--------------------------------------------------------------------------------------------S#SS-----------------SSSS--------------------------------------------------S--------
---------------------------------------------------------------------##---------------------------------------------------------------------------------------------------------
--------------------------------------------------------------------###--------------------------------------------------------------------S------------------------------------
--------------------------------------#----------------------------####-----------------------------K-------------K--------------------------------------------------------#----
-------------------------SSSSS------####------QQ------------------####------SS----------------------SS---------SSSSSS----------S-------------------------------------S----##----
-------------------TT--------------##-##-----------*------TT-----#####-------------------T--------------------------K----#---------------K---*---------*-----------------###----
-------------*------T-------------######-----------*------TT----######-------------------T---------------#--------------##-------------------*----T----*-------*--------####----
-------------*------T------------#######-----------B------TT----######-------------------T--------------#--------------#-#-------------------*----TT-----------*-------#####---#
XXXXXXXXXXXXXXXX--XXXXXXXXXXXXXXXXXXXXXXXXXXXXXXXXXXXXXXXXXXXXXXXXXXXXXXXXXXXXXXXXXXXX--XXXXXXXXXXXXXXXXXXXXXXXXXXXXXXXXXXXXXXXXXXXXXXXXXXXXXXXXXXXXXXXXXXXXXXXXXXXXXXXXXXXXXXXX
XXXXXXXXXXXXXXXX--XXXXXXXXXXXXXXXXXXXXXXXXXXXXXXXXXXXXXXXXXXXXXXXXXXXXXXXXXXXXXXXXXXXX--XXXXXXXXXXXXXXXXXXXXXXXXXXXXXXXXXXXXXXXXXXXXXXXXXXXXXXXXXXXXXXXXXXXXXXXXXXXXXXXXXXXXXXXX