--------------------------------------------------------------------------------------------------------------------------------------------------------------------------------
--------------------------------------------------------------------------------------------------------------------------------------------------------------------------------
--------------------------------------------------------------------------------------------------------------------------------------------------------------------------------
--------------------------------------------------------------------------------------------------------------------------------------------------------------------------------
--------------------------------------------------------------------------------------------------------------------------------------------------------------------------------
--------------------------------------------------------------------K-----------------------------------------------------------------------------------------------------------
----------------------------------------S-------------------SSSSSSSSSSS----------------------#--------------------------------------------------------------------------S-------
---------------------------------------------------------------------------------------------##---------------------------------------------------------------------------------
-----------------------------#-------------------------------------------S------------------######----------S------------*------------------------------------------------------
----------------------------##-----------------------------------K-------------------------#######-----------------------*------------------------------------------------------
---------------------------###------S-----------------------SSSSSSSSSS--------------------########---#------------------S#CS----SS----------------------------SS------S---------
-------#--------------TT--####-----------------*----------------------------------TT-----#########---#-------------------------------K---*--------------------------------------
------T#--------T-----TT--####-----------------*----TT----------------------------TT----###########--#----------------TT-----------------*-----------*----TT-----*-----T--------
------##--------TT----TT-######----------------B----TT-----------------------*----TT---############--#----------------TT------------#----#-----------*----TT-----*----TT--------
XXXXXXXXXXXXXXXXXXXXXXXXXXXXXXXXXXXXXXXXXXXXXXXXXXXXXXXXXXXXXXXXXXXXXXXXXXXXXXXXXXXXXXXXXXXXXXXXXXXXXXXXXXXXXXXXXXXXXXXXXXXXXXXXXXXXXXXXXXXXXXXXXXXXXXXXXXXXXXXXXXXXXXXXXXXXXXXX
XXXXXXXXXXXXXXXXXXXXXXXXXXXXXXXXXXXXXXXXXXXXXXXXXXXXXXXXXXXXXXXXXXXXXXXXXXXXXXXXXXXXXXXXXXXXXXXXXXXXXXXXXXXXXXXXXXXXXXXXXXXXXXXXXXXXXXXXXXXXXXXXXXXXXXXXXXXXXXXXXXXXXXXXXXXXXXXX