--------------------------------------------------------------------------------------------------------------------------------------------------------------------------------
--------------------------------------------------------------------------------------------------------------------------------------------------------------------------------
--------------------------------------------------------------------------------------------------------------------------------------------------------------------------------
--------------------------------------------------------------------------------------------------------------------------------------------------------------------------------
--------------------------------------------------------------------------------------------------------------------------------------------------------------------------------
-------------------------------------------------------------------------------------------------------------------------------------------S------------------------------------
------------------------------------------------SSSSS-----------------------------------------------------------------------------------SSSS----------------------------SS------
--------------------------------------------------------------------#-----------------------------------------------------------------------------------------------------------
-------------------------------------------------------------------##-----------------------------------------------------------------------------------------------------------
-----------------------------------------------K------------------##---------------------------------------------------------------------*------------------------------K-------
-----------------------------------------------SSSS--------------####--S-------SSSS-------------------------------QQQ----------------SSSS#CS------------------SS--------SS------
--------------------------TT-------*-----TT---------------------####-----*-------------------K--------------------------#----*-----------------------K---*----------------------
---------*-----*----T-----TT-------*-----TT---------------TT---#####-----*------------###--------*-------------*-------###---*---*--------------*--------*----------------------
---------*-----*----TT----TT-------*------T--------*------TT---###-#-----*-----------####----------------------*------#-##---B---*----T------------------*----------------------
XXXXXXXXXXXXXXXXXXXXXXXXXXXXXXXXXXXXXXXXXXXXXXXXXXXXXXXXXXXXXXXXXXXXXXXXXXXXXXXXXXXXXXXXXXXXXXXXXXXXXXXXXXXXXXXXXXXXXXXXXXXXXXXXXXXXXXXXXXXXXXXXXXXXXXXXXXXXXXXXXXXXXXXXXXXXXXXX
XXXXXXXXXXXXXXXXXXXXXXXXXXXXXXXXXXXXXXXXXXXXXXXXXXXXXXXXXXXXXXXXXXXXXXXXXXXXXXXXXXXXXXXXXXXXXXXXXXXXXXXXXXXXXXXXXXXXXXXXXXXXXXXXXXXXXXXXXXXXXXXXXXXXXXXXXXXXXXXXXXXXXXXXXXXXXXXX