--------------------------------------------------------------------------------------------------------------------------------------------------------------------------------
--------------------------------------------------------------------------------------------------------------------------------------------------------------------------------
--------------------------------------------------------------------------------------------------------------------------------------------------------------------------------
--------------------------------------------------------------------------------------------------------------------------------------------------------------------------------
--------------------------------------------------------------------------------------------------------------------------------------------------------------------------------
------------------K-------------------------------------------------------------------------------------------------------------------------------------------------------------
---------------------------------------------------------------------------------------------------------------------------------------------------------------S----------------
------------------------------------------------------------------K-------------------------------------------------------------------------------------------------------------
------------------------------------------------------------------S-------------------------------------------------------------------------------------------------------------
---------------------------------------------------------------------------------------------------------------------------------------#----------------------------------------
------------##----------------------------------------------------------------SSS----SSS----------------------------------------------##--------------------SS-------------QQQ--
-----------###-K---*-------------*-----------------------------K---*------------------------TT---------*-----------------------------#####-----TT----------------*--------------
----------####-----*---*---------*----TT----TT-----*-----*---------*-----*------------------TT---------------------*-----*---------###-###-----TT------*---------*---*----------
----------##-#-----*---*---------*----TT----TT-----*-----*---------B-----*------------------TT-----------*---------------*---------#######-----T---k---*---------*---*----------
XXXXXXXXXXXXXXXXXXXXXXXXXXXXXXXXXXXXXXXXXXXXXXXXXXXXXXXXXXXXXXXXXXXXXXXXXXXXXXXXXXXXXXXXXXXXXXXXXXXXXXXXXXXXXXXXXXXXXXXXXXXXXXXXXXXXXXXXXXXXXXXXXXXXXXXXXXXXXXXXXXXXXXXXXXXXXXXX
XXXXXXXXXXXXXXXXXXXXXXXXXXXXXXXXXXXXXXXXXXXXXXXXXXXXXXXXXXXXXXXXXXXXXXXXXXXXXXXXXXXXXXXXXXXXXXXXXXXXXXXXXXXXXXXXXXXXXXXXXXXXXXXXXXXXXXXXXXXXXXXXXXXXXXXXXXXXXXXXXXXXXXXXXXXXXXXX