--------------------------------------------------------------------------------------------------------------------------------------------------------------------------------
--------------------------------------------------------------------------------------------------------------------------------------------------------------------------------
--------------------------------------------------------------------------------------------------------------------------------------------------------------------------------
--------------------------------------------------------------------------------------------------------------------------------------------------------------------------------
--------------------------------------------------------------------------------------------------------------------------------------------------------------------------------
--------------------------------------------------------------------------------------------------------------------------------------------------------------------------------
--------------------------------S#----------------------------S--------------SSSS---------------------------------------------------------------S-------------------------------
--------------------------------------------------------------------------------------------------------------------------------------------------------------------------------
----------------------------------------------------1---------------------------------------------------------------------------------------------------------------------------
--------------------------------------------------------------#---------------K*---#--------------------------------------------------------------------------------------------
-------------------------------------------------------------##--------------SS#SS-#-------------------------------------------------------S##--QQ-------------------SSS--------
----------------------------------------------------TT------###--------------------#----------TT--------------TT-----------TT-----------------------------------TT---------*----
-------*----TT------TT----TT---------*-------*------TT-----####--------------------##---------TT--------------TT-----*-----T---------*---------------*-----*T---TT--------------
-------*-----T-*----TT----TT---------B--------------TT-----####-------------------###---------TT---------------T-----*-----T---------*-------#-------*-----*T---TT--------------
XXXXXXXXXXXXXXXXXXXXXXXXXXXXXXXXXXXXXXXXXXXXXXXX----XXXXXXXXXXXXXXXXXXXX---XXXXXXXXXXXXXXXXXXXXXXXXXXXXXXXXXXXXXXXXXXXXXXXXXXXXXXXXXXXXXXXXXXXXXXXXXXXXXXXXXXXXXXXXXXXXXXXXXXX--
XXXXXXXXXXXXXXXXXXXXXXXXXXXXXXXXXXXXXXXXXXXXXXXX----XXXXXXXXXXXXXXXXXXXX----XXXXXXXXXXXXXXXXXXXXXXXXXXXXXXXXXXXXXXXXXXXXXXXXXXXXXXXXXXXXXXXXXXXXXXXXXXXXXXXXXXXXXXXXXXXXXXXXXX--