--------------------------------------------------------------------------------------------------------------------------------------------------------------------------------
--------------------------------------------------------------------------------------------------------------------------------------------------------------------------------
--------------------------------------------------------------------------------------------------------------------------------------------------------------------------------
--------------------------------------------------------------------------------------------------------------------------------------------------------------------------------
--------------------------------------------------------------------------------------------------------------------------------------------------------------------------------
--------------------------------------------------------------------------------------------------------------------------------------------------------------------------------
------S---------------------------------------------------------------------SS--------------------------------------------------------------------------------------------------
--------------------------------------------------------------------------------------------------------------------------------------------------------------------------------
---------------------------------*-----------------------------SSS---------------------------------#---------------------------------------------------#-----------------*------
---------------------------------*---------------------------------*-----------*------------------##--------------------------------------------------##-----------------*------
----SSSS------------------------S#CS--------------------------------SS------SSS#CS---------------###-------------------------------------------------###----------------S#CS----
-------------------------K---*---------------------K---*----------------------------------------####---*-----*-------TT------*----------------------####------------------------
-----------*----TT-----------*-------*-----T-----------*--------S------------------*-----*-----#####---*-----*-------TT------*---------------*-----*####---------*-----------*--
-----------*----TT-----------B-------*-----T-----------B---------------------------*-----*----######---B-------------T-------#---------------*-----#####---------*-----------*--
XXXXXXXXXXXXXXXXXXXXXXXXXXXXXXXXXXXXXXXXXXXXXXXXXXXXXXXXXXXXXXXXXXXXXXXXXXXXXXXXXXXXXXXXXXXXXXXXXXXXXXXXXXXXXXXXXXXXXXXXXXXXXXXXXXXXXXXXXXXXXXXXXXXXXXXXXXXXXXXXXXXXXXXXXXXXXXXX
XXXXXXXXXXXXXXXXXXXXXXXXXXXXXXXXXXXXXXXXXXXXXXXXXXXXXXXXXXXXXXXXXXXXXXXXXXXXXXXXXXXXXXXXXXXXXXXXXXXXXXXXXXXXXXXXXXXXXXXXXXXXXXXXXXXXXXXXXXXXXXXXXXXXXXXXXXXXXXXXXXXXXXXXXXXXXXXX