--------------------------------------------------------------------------------------------------------------------------------------------------------------------------------
--------------------------------------------------------------------------------------------------------------------------------------------------------------------------------
--------------------------------------------------------------------------------------------------------------------------------------------------------------------------------
--------------------------------------------------------------------------------------------------------------------------------------------------------------------------------
-------------------------------------------------------------------------------------------------------------------#------------------------------------------------------------
--------------------------------------------------------------------------------k---------------------------------##------------------------------------------------------------
----------------------------------------SS------------------------------------###S-------------------------------###-----------------------------------------------------S------
-----------------------------------------------------------------------------###--------------------------------####------------------------------------------------------------
---------------------------------------------------------------*------------####----------------SSSS-----------#####------------------------------------------------------------
---------------------------------------------K-----------------*-----------#####------------------------------######-------------------------------------*----------------------
-----------------------------------S-SS-SS-SSSSS--------------S#CS--------#-####---------------------S-------#######-----*-------------------------------#CS--------------------
------------------------------T--------------------*----TT----------------#-####-----------------K-----------#######-----*--------TT-----*----------TT--------------------------
---------*------TT---*TT-----TT--------------------*----TT---------*--T--------#--------TT-------------*----#######---------------TT-----*----------TT----------TT-------*------
---------*------TT----TT-----TT--------------------*----TT-k-------*--------------------TT-------------*----#######---------------TT----------------TT----------TT-------*------
XXXXXXXXXXXXXX--XXXXXXXXXX-XXXXXXXXXXXXXXXXXXXXXXXXXXXXXXXXXXXXXXXXXXXXXXXXXXXXXXXXXXXXXXXXXXXXXXXXXXXXXXXXXXXXXXXXXXXXXXXXXXXXXXXXXXXXXXXXXXXXXXXXXXXXXXXXXXXXXXXXXXXXXXXXX----
XXXXXXXXXXXXXX--XXXXXXXXXX-XXXXXXXXXXXXXXXXXXXXXXXXXXXXXXXXXXXXXXXXXXXXXXXXXXXXXXXXXXXXXXXXXXXXXXXXXXXXXXXXXXXXXXXXXXXXXXXXXXXXXXXXXXXXXXXXXXXXXXXXXXXXXXXXXXXXXXXXXXXXXXXXX----