-----------------------------------------------------------------------------------------------------------------------------------------------------------------------------------------------------
-----------------------------------------------------------------------------------------------------------------------------------------------------------------------------------------------------
-----------------------------------------------------------------------------------------------------------------------------------------------------------------------------------------------------
-----------------------------------------------------------------------------------------------------------------------------------------------------------------------------------------------------
-----------------------------------------------------------------------------------------------------------------------------------------------------------------------------------------------------
-----------------------------------------------------------------------------------------------------------------------------------------------------------------------------------------------------
--------------------------------SSS-------------------------------------------------------------------------S-SSSS---------------------------------------Q--------USS--------------------------------
-----------------------------------------------------------------------------------------------------------------------------------------------------------------------------------------------------
-------------------------------------------S---------------------------------S-----------SS------------S---------------S---------------##------------------------------------------------------------
-------------------------------------------------------------------g-------------------------------------------------------------------##------------------------------------------------------------
--------------------------QQQQ-------------------------------2S----T---------------------------##g-----T-------QQQQ--------------------##-------S------QQ-QQ-----------T-----T-------S---------------
----------------------------------TT----------g--------------------TT----------------------#---##----------tt--------------gg--------#####-----------------------------TT----T---------------TT------
-----------------------------------T----------TT-------------------TT--------------------###---##----------T---------------TT--------#####-----------------------------TT----TT--------------TT------
-------------K-------g---------gg--T-----gg---TT-------ggg-----k---TT--------------------###---##----------T-----------gg---T-------######-------K-----T-----g----gg---TT----TT------k-----g-TT------
XX--XXXXX-XXXXXXXXXXXXXXXXXXXXXXXXXXXXXXXXXXXXXXXXXXXXXXXXXXXXXXXXXXXXXXXXXXXXXXXXXXXXXX-XXXXXXXXXXXXXXXXXXXXXXXXXXXXXXXXXXXXXXXXXXXXXXXXXXXXXXXXXXXXXXXXXXXXXXXXXXXXXXXXXXXXXXXXXXXXXXXXXXXXXXXXXXXX
XX--XXXXX-XXXXXXXXXXXXXXXXXXXXXXXXXXXXXXXXXXXXXXXXXXXXXXXXXXXXXXXXXXXXXXXXXXXXXXXXXXXXXX--XXXXXXXXXXXXXXXXXXXXXXXXXXXXXXXXXXXXXXXXXXXXXXXXXXXXXXXXXXXXXXXXXXXXXXXXXXXXXXXXXXXXXXXXXXXXXXXXXXXXXXXXXXX