-----------------------------------------------------------------------------------------------------------------------------------------------------------------------------------------------------
-----------------------------------------------------------------------------------------------------------------------------------------------------------------------------------------------------
-----------------------------------------------------------------------------------------------------------------------------------------------------------------------------------------------------
-----------------------------------------------------------------------------------------------------------------------------------------------------------------------------------------------------
-----------------------------------------------------------------------------------------------------------------------------------------------------------------------------------------------------
-----------------------------------------------------------------------------------------------------------------------------------------------------------------------------------------------------
-------------------------------SS------------------------------------------------------SS-----------------S--------------S----SS----------------------SS------------SS-------------------------------
-----------------------------------------------------------------------------------------------------------------------------------------------------------------------------------------------------
----------------QS--------------------------------------------------SS-----------------------------------------------------------------------S-----------------------------#-------------------------
---------------------------------------------------------------------------------------------------------------------------------------------------------------------------g#------------------------
-----------------------------------#--------Q---------QQ---------Q----------TT----------------------------------------------------TT---------------------------------------TT--------SSS-------------
------------------------T----------#------------T---------------------------TT-----------T-------T-----TT----------------------t--T------------------------------T---#-----TT------------------------
--------T----------------T----------------------TT--------------------------TT-----------T-------TT----TT----------------------t-TT----------------TT-----------#T---##----TT------------------------
--------T----------------T----k-----------------TT---------g-------k-g------TT------k------------TT----TT------------gg------gt--TT----------------TT----------#-T---###---TT------------------------
XXXXXXXXXX-----XXXXXXXXXXXXXXXXX---XXXXXXXXXXXXXXXXXXXXXXXXXXXXXXXXXXX---XXXXXXXXXXXXX---XXXXXXXXXXXXXXXXXXXXX---XXXXXXX---XXXXXXXXXXXXXXXX----XXXXXXX------XXXXXXXXXXXXXXXXXXXXXXXXXXXXXXXXXXXXXXXX-
XXXXXXXXXX-----XXXXXXXXXXXXXXXXX---XXXXXXXXXXXXXXXXXXXXXXXXXXXXXXXXXXXX--XXXXXXXXXXXXX---XXXXXXXXXXXXXXXXXXXXX---XXXXXXX---XXXXXXXXXXXXXXXX----XXXXXXX------XXXXXXXXXXXXXXXXXXXXXXXXXXXXXXXXXXXXXXXXX