-----------------------------------------------------------------------------------------------------------------------------------------------------------------------------------------------------
-----------------------------------------------------------------------------------------------------------------------------------------------------------------------------------------------------
-----------------------------------------------------------------------------------------------------------------------------------------------------------------------------------------------------
-----------------------------------------------------------------------------------------------------------------------------------------------------------------------------------------------------
-----------------------------------------------------------------------------------------------------------------------------------------------------------------------------------------------------
-----------------------------------------------------------------------------------------------------------------------------------------------------------------------------------------------------
------SS------------------------------------------------------------------------------------------SS--------------------------------QQQQQ-QQQQQSSS---------------------------------------------------
-----------------------------------------------------------------------------------------------------------------------------------------------------------------------------------------------------
--------------S------#-----------------------Q-----------------------------------------------------------------------------------------------------------------------------------S-------------------
--------------------##-------------------------------------------------------------------------------------------------------------------------------------------------------------------------------
--------------------#-----------TT------TT------------TT--------------TT-----------USS------SSSS-------------------------------------TT------------------------------------------------------TT------
-------------------##-----------TT--------------------TT--------------TT-------------------------------------------T-----------------TT------------------------------TT----------------------TT------
--------------------------------TT--------------------TT--------------TT-------------------------------------------T-----------------TT------------------------------TT--t-------------------TT------
-----------------#--##----ggg----T--------------------TT-----T----XX--TT-----------------------gg-----------gg-----T---------k-------TT----g---k----ggg----TT-g------TT-Xtt------------g-g---TT------
--XXXXXXXXXXXXXXXXXXXXXXXXXXXXXXXXXXXXXXXXXXXXXXXXXXXXXXXXXXXXXXXXXXXXXXXXXXXXXXXXXXXXXXXXXXXXXXXXXXXXXXXXXXXXXXXXXXXXXXXXXXXXXXXXXXXXXXXXXXXXXXXXXXXXXXXXXXXXXXXXXXXXXXXXXXXXXXXXXXXXXXXXXXXXXXXXXXX
--XXXXXXXXXXXXXXX-XXXXXXXXXXXXXXXXXXXXXXXXXXXXXXXXXXXXXXXXXXXXXXXXXXXXXXXXXXXXXXXXXXXXXXXXXXXXXXXXXXXXXXXXXXXXXXXXXXXXXXXXXXXXXXXXXXXXXXXXXXXXXXXXXXXXXXXXXXXXXXXXXXXXXXXXXXXXXXXXXXXXXXXXXXXXXXXXXXX