-----------------------------------------------------------------------------------------------------------------------------------------------------------------------------------------------------
-----------------------------------------------------------------------------------------------------------------------------------------------------------------------------------------------------
-----------------------------------------------------------------------------------------------------------------------------------------------------------------------------------------------------
-----------------------------------------------------------------------------------------------------------------------------------------------------------------------------------------------------
-----------------------------------------------------------------------------------------------------------------------------------------------------------------------------------------------------
-----------------------------------------------------------------------------------------------------------------------------------------------------------------------------------------------------
-------------------------------------SS------------------------USS--------------------SS--------------------------------------------------SS---------------------------------------------------------
-----------------------------------------------------------------------------------------------------------------------------------------------------------------------------------------------------
---------------------------------------------------------------------------------------------------------SSS----------------------------------------------------------------------------------S------
-------------------------------------------------------------------------------------#---------------------------------------------------------------------------#-----------------------------------
-----------------------------------C-----------------------#-----TT-----QQ---USSS----#------------------------------------------------QQQ------------------------#-----------------S-----------------
-----------T---------------T-------------------------------#-----TT------------------#-----------------------------T--------------------------------------------##-----------------------------------
-----------##-------------TT-------------------T-----------#-----TT------------------#-----------------TT----------TT------#-----------------------------------###-----------------------------------
-----#-----#--------------TT--------ggg--------T-------k---##----TT--------------k---#------gg---------TT----gg----TT--t---#-----------k----gg---------gg----######----------gg----------gg--kk------
XXXXXXXXXXXX-----XXXXXXXXXXXXXXXXXXXXXXX---XXXXXXXXXXXXXXXXXXXXXXXXXXXXXXXXXXXXXXXXXXXXXXXXXXXX----X---XXXX--XXXXXXXXXXXXXXXX--XXXXXXXXXXXXXXX---XXXXXXXXXXXXXXXXXXXXXXXXXXXXXXX----XXXXXXXXXXXXX----
XXXXXXXXXXXX-----XXXXXXXXXXXXXXXXXXXXXXX---XXXXXXXXXXXXXXXXXXXXXXXXXXXXXXXXXXXXXXXXXXXXXXXXXXXX----X---XXXX-XXXXXXXXXXXXXXXXX--XXXXXXXXXXXXXXX---XXXXXXXXXXXXXXXXXXXXXXXXXXXXXXX----XXXXXXXXXXXXX----