-----------------------------------------------------------------------------------------------------------------------------------------------------------------------------------------------------
-----------------------------------------------------------------------------------------------------------------------------------------------------------------------------------------------------
-----------------------------------------------------------------------------------------------------------------------------------------------------------------------------------------------------
-----------------------------------------------------------------------------------------------------------------------------------------------------------------------------------------------------
-----------------------------------------------------------------------------------------------------------------------------------------------------------------------------------------------------
-----------------------------------------------------------------------------------------------------------------------------------------------------------------------------------------------------
------------SS-------------------------------------------------#-------------------------------------------------------------------SSSSSSS-----------------------------------------------------------
---------------------------------------------------------------#-------------------------------------------------------------------------------------------------------------------------------------
-----------------------------------------------------------------------------------S-------Q-S-------------------------------------------------------------------------S---SSSSS---------------------
------------------------------g--------------------------------#-------------------------------------------------------------------------------------------------------------------------------------
------------------------------TT------------------TT-----S-----#----QQ-----------------------------T------QQQ----------------------TT--------------TTQ---QQ---QQQ----------------------------TT------
------TT--------------TT-------T------------------TT-----------#-----------------------------------TT---------------------TT-------TT--t-----------TT----------------T-----------------------TT------
------TT--------------TT--tt---T------------------TT-----------#-----------------------------------TT---------------------TT-------TT--------------TT----------------T-----------------------TT------
------TT-----k---g----TT--gg---T---------k--gg----TT-------k---#-----g---------------g-----g--gg---TT------------g---g----TT-------TT--------------TT------------k-K-T-------------------k---TT------
--XXXXXXXXXXXXXXXXXXXXXXXXXXXXXXXXXXXXXXXXXXXXXXXXXXXXXXXXXXXXXXXXXXXXXXXXXXXXXXXXXXXXXXXXXXXXXXXXXXXXXXXXXXXXXXXXXXXXXXXXXX--XXXXXXXXXXXXXXXXXXXXXXXXXXXXXXXXXXXXXXXXXXXXXXXXXXXXXXXXXXXXXXXXXXXXXXX
--XXXXXXXXXXXXXXXXXXXXXXXXXXXXXXXXXXXXXXXXXXXXXXXXXXXXXXXXXXXXXXXXXXXXXXXXXXXXXXXXXXXXXXXXXXXXXXXXXXXXXXXXXXXXXXXXXXXXXXXXX---XXXXXXXXXXXXXXXXXXXXXXXXXXXXXXXXXXXXXXXXXXXXXXXXXXXXXXXXXXXXXXXXXXXXXXX