-----------------------------------------------------------------------------------------------------------------------------------------------------------------------------------------------------
-----------------------------------------------------------------------------------------------------------------------------------------------------------------------------------------------------
-----------------------------------------------------------------------------------------------------------------------------------------------------------------------------------------------------
-----------------------------------------------------------------------------------------------------------------------------------------------------------------------------------------------------
-----------------------------------------------------------------------------------------------------------------------------------------------------------------------------------------------------
-----------------------------------------------------------------------------------------------------------------------------------------------------------------------------------------------------
----------------------SS----------------------------------------SS----------------------------------SSCSSS-----------------------------------------------S-------------------------------------------
-----------------------------------------------------------------------------------------------------------------------------------------------------------------------------------------------------
--------------------------------SSSS-------------------------------------------g-----g---------------------------------------------------------------------------------------------------------------
-------------------------------------------------------------------------------#---------------------------------------------------------------------------------------------------------------------
---------------------------------------------------------#--------------------##-----QQQ----Q----------------------------------------------------TT----QQQ----T----------T-----TT--------TT----------
---------------------------------------------------------#-------------------###-------------------------------TT--------------------------------TT-----------TT---------T-----TT--------T-----------
---------------------------------------------------------#------------------####-------------------------------TT--------------------------------TT-----------TT---------T-----TT--------T-----------
----gg-----------------------------------------k-----g---#-------------gg---####-------------k-ggg-----g-------TT-------g------k---##-----ggg----TT-------g---TT-----k---T-----TT--gg----T-------g---
--XXXXXXXX---XXXXXXXXXXXXXXXXXXXXXXXXXXXXXXXXXXXXXXXXXXXXXXXXXXXXXXXXXXXXXX----XXXXXX----XXXXXXXXXXXXXXXXXXXXXXXXXXXXXXXXXXXXXXXXXXXXXXXXXXXXXXXXXXXXXXXXXXXXXXXXXXXXXXXXXXXXXXXXXXXXXXXXXXXXXXXXXXXX
--XXXXXXXX---XXXXXXXXXXXXXXXXXXXXXXXXXXXXXXXXXXXXXXXXXXXXXXXXXXXXXXXXXXXXXX----XXXXXX----XXXXXXXXXXXXXXXXXXXXXXXXXXXXXXXXXXXXXXXXXXXXXXXXXXXXXXXXXXXXXXXXXXXXXXXXXXXXXXXXXXXXXXXXXXXXXXXXXXXXXXXXXXXX