-----------------------------------------------------------------------------------------------------------------------------------------------------------------------------------------------------
-----------------------------------------------------------------------------------------------------------------------------------------------------------------------------------------------------
-----------------------------------------------------------------------------------------------------------------------------------------------------------------------------------------------------
-----------------------------------------------------------------------------------------------------------------------------------------------------------------------------------------------------
---------------------------------------------------------------------------------------------------------------------#-------------------------------------------------------------------------------
-----------------------------------------------------------------------------------#---------------------------------##------------------------------------------------------------------------------
--------------------------------------------------------------SS-------------------#-------------LSQ-----------QQQ---##-------------------------------------S----------------------------------------
-----------------------------------------------------------------------------------#---------------------------------##------------------------------------------------------------------------------
-----------------------------------------------------------------------------------#---------------------------------##------------------------tt------------------------S---------------------------
-----------------------------------------------------------------------------------#----------------------------k----##------------------------tt--------------------------------------##------------
-------------------------SS----------------g---#-------Q-----------------------------------------QQ-QQ-----TT--?QQ---##------------------------tt--------C-----------------------------##----TT------
-----------------------------------------------#---------------------------------------------------------------------##------------------------tt----------------TT--------------------##----TT------
-----------------------------------------------#---------------------------------------------------------------------##------------------------tt----------------TT-t------------------##----TT------
------gg----------gg-----g---gg------------#---#----------XX-----------k--------------------------------------------###------------------------------------gg----TTtt--------g----T---###----TT----k-
XXXXXXXXX--XXXXXXXXXXXXXXXXXXXXXXXXXXXXXXXXXXXXXXXXXXXXXXXXXXXXXXXXXXXXXXXXXXXXXXXXXXXXXXXXXXXXXXXXXXXXXXXXXXXXXXXXXXXXXXXXXXX----XXXXXXXXXXXXXXXXXXXXXXXXXXXXXXXXXXXXXXXXXXXXXXXXXXXXXXXXXXXXXXXXXXX
XXXXXXXXX--XXXXXXXXXXXXXXXXXXXXXXXXXXXXXXXXXXXXXXXXXXXXXXXXXXXXXXXXXXXXXXXXXXXXXXXXXXXXXXXXXXXXXXXXXXXXXXXXXXXXXXXXXXXXXXXXXXX----XXXXXXXXXXXXXXXXXXXXXXXXXXXXXXXXXXXXXXXXXXXXXXXXXXXXXXXXXXXXXXXXXXX