-----------------------------------------------------------------------------------------------------------------------------------------------------------------------------------------------------
-----------------------------------------------------------------------------------------------------------------------------------------------------------------------------------------------------
-----------------------------------------------------------------------------------------------------------------------------------------------------------------------------------------------------
-----------------------------------------------------------------------------------------------------------------------------------------------------------------------------------------------------
-----------------------------------------------------------------------------------------------------------------------------------------------------------------------------------------------------
-----------------------------------------------------------------------------------------------------------------------------------------------------------------------------------------------------
-----S---------------QQQQQQSS----QQQ-----------------------------------------------------------------------------------------#-----SS---------S--------------------Q---------------------------------
-----------------------------------------------------------------------------------------------------------------------------------------------------------------------------------------------------
----------------------------------------------------------------------------------------------------S--------------------------------------------------S---g-----------------------------------------
------------------------------------------------------------g----------------------------------------------------------------------------------------------------------------------------------------
---------------------QQQ-------QQQQ-------------------------TT----------------TT---Q-------TT----------Q-------------------------TT-------S------------------------QQQQQQ--QQQ--------SS-------------
------------------------------------------------------------TT----------------TT-----------TT----------T-------------------------TT------------------------------------------------------------------
---------------------------------------------------#--------TT----------------TT-----------TT----------T-----------------#-------TT--------------------------------------------------------T#--------
-----------------------------------k-------g-----k----ggg---TT---------g------TT----gg------T----T-----T-------k-----T---#-------TT----------------gg----------------------------------k---T---------
--XXXXXX--XXXXXXXXXXXXXXXXXXXXXXXXXXXXXXXXXXXXXXXXXXXXXXXXXX---XXXXXXXXXXXXXXXXXXXXXXXXXXXXXXXXXXXXXXXXXXXXXXXXXXXXXXXXXXXXXXXXXXXXXXXXXXXXXXXXXXXXXXXXX---XXXXXXXXXXXXXXXXXX--XXXXXXXXXXXXX----XXXXX
--XXXXXX--XXXXXXXXXXXXXXXXXXXXXXXXXXXXXXXXXXXXXXXXXXXXXXXXXX---XXXXXXXXXXXXXXXXXXXXXXXXXXXXXXXXXXXXXXXXXXXXXXXXXXXXXXXXXXXXXXXXXXXXXXXXXXXXXXXXXXXXXXXXX---XXXXXXXXXXXXXXXXXX--XXXXXXXXXXXXX----XXXXX