-----------------------------------------------------------------------------------------------------------------------------------------------------------------------------------------------------
-----------------------------------------------------------------------------------------------------------------------------------------------------------------------------------------------------
-----------------------------------------------------------------------------------------------------------------------------------------------------------------------------------------------------
-----------------------------------------------------------------------------------------------------------------------------------------------------------------------------------------------------
---------------------------------------------------------------------------------------------------------------------------------#-------------------------------------------------------------------
---------------------------------------------------------------------------------------------------------------------------------#-------------------------------------------------------------------
-----------SSS-----------------------------------------SSS----------------------------------------------------------SSSSS-----------------SSS---------------------------------S--S-------------------
-----------------------------------------------------------------------------------------------------------------------------------------------------------------------------------------------------
---------------------------------------------S-------------------------------------------------------S------SS---------------------SS------------------------------------------------S---------------
-----------------------------------------------------------------------------------------------------------------------------------------------------------------------------------------------------
----TT----------TT-------------------QQQ---C---------------#----------------TT-------QQ------T-----------------------T-----QQ---------------------------------------------QQQQQ----------------------
-----T----------TT--------------------------------T--------#----------------TT---------------T-----------------------TT----------------TT-----------------------T------------------------------------
-----T----------TT--------------------------------TT-------#-------------t--TT---------------T------------------T----TT----------------TT-----T-----------------T------------------------------------
-----T----------TT---------g-----------------k----TT-------#----gg------gt--TT-----------k---T-----g-----gg-----T----TT---k------------TT-----T------gg---------T----T-----------k-------k-----------
XXXXXXXXXXXXXXXXXXXXXXXXXXXXXXXXXXXXXXXXXXXXXXXXXXXXX---XXXXXXXXXXXXXXXXXXX-XXXXXXXXXXXXXXXXXXXXXXXXXXXXXXXXXXXXXXXXXXXXXXXXX---XXXX---XXXXXXXXXXXXXXXXXXXXX---XXXXXXXX--XXXXXXXXXXXXXXXXXXXXXXXXXXXX
XXXXXXXXXXXXXXXXXXXXXXXXXXXXXXXXXXXXXXXXXXXXXXXXXXXXX---XXXXXXXXXXXXXXXXXXX-XXXXXXXXXXXXXXXXXXXXXXXXXXXXXXXXXXXXXXXXXXXXXXXXX---XXXX---XXXXXXXXXXXXXXXXXXXXX---XXXXXXXX--XXXXXXXXXXXXXXXXXXXXXXXXXXXX