----------------------------------------------------------------------------------------------------------------------------------------------------------------------------------------------------------------------
----------------------------------------------------------------------------------------------------------------------------------------------------------------------------------------------------------------------
-----------------------------------------------------------------------------------------------------------------------------------------------------S----------------------------------------------------------------
----------------------------------------------------------------------------------------------------------------------------------------------------K-----------------------------------------------------------------
----------------------------------------------------------------------------------------------------------------------------------------------------------------------------------------------------------------------
------------------------------------------------------------#---------------------------------------------------------------------------------------------------------------------------------------------------------
--------------------SSSSS---S------------------------------##-----------------------------------------------------------------------------------------------------------------------TT--------TT----------------------
------------------------------------------------------------#-----------------------------------------------------------------------------------------------------------------------TT--------TT----------------------
------------------------------------------------SSS---------#--SS--------------------------------------------------------------------------------------------------------------------X--------X-----------------------
----------------------------------------------------------###---------------------------------------------------------------------##----------------------------------------------------------------------------------
--------------------------------------------------------T-####------------TT------tt----------------SS-----tt-----------SS-------##---------TT----------TT----------------TT--------------TT--S--------------#SS------
------------------------------------TT----------------------#-------------TT--TT--t--T--TT------------------t------------------T-##---------TT----------TT------#---------TT------T-------TT-----T--------------------
----------t--T--TT--------TT--------TT------------------------------------TT--TT--TTTT--TT--TTTT------------t----------------T---##-TT------------------TT-----##-TT------TT----TTTT----#-TT-----T------TT---#--------
----------t--T--TT--------TT--------TT------------------------X-----------TT--TT--TT-T--TT--TTTT---------k--tt--------------TT---##-TT------------------tt----###-TT------TT----TTTT---k--TT--k--T------TT---#--------
XXXXXXXXXXXXXXXXXXXXXX--XXXXXXXXXXXXXXXXXXXXXXXXXXX---XXXXXXXXXX--XXXXXXXXXXXXXXXXXXXXXXXXXXXXXXXXXXXXXXXXXXXXXXXXXXXXXXXXXXXXXXXXX-XXXXXXXXXXX-XX----XXXXXXXXXXX-XXXXXXXXXXXXXXXXXXXXXXXXXXXXXXXXXXXXXXXXXXXXXXXX----
XXXXXXXXXXXXXXXXXXXXXX--XXXXXXXXXXXXXXXXXXXXXXXXXXX---XXXXXXXXXX--XXXXXXXXXXXXXXXXXXXXXXXXXXXXXXXXXXXXXXXXXXXXXXXXXXXXXXXXXXXXXXXXX-XXXXXXXXXXX-------XXXXXXXXXXX-XXXXXXXXXXXXXXXXXXXXXXXXXXXXXXXXXXXXXXXXXXXXXXXX----