----------------------------------------------------------------------------------------------------------------------------------------------------------------------------------------------------------------------
----------------------------------------------------------------------------------------------------------------------------------------------------------------------------------------------------------------------
----------------------------------------------------------------------------------------------------------------------------------------------------------------------------------------------------------------------
----------------------------------------------------------------------------------------------------------------------------------------------------------------------------------------------------------------------
----------------------------------------------------------------------------------------------------------------------------------------------------------------------------------------------------------------------
----------------------------------------------------------------------------------------------------------------------------------------------------------------------------------------------------------------------
--------------------------------------SSSSSSS---------------SSS---SSSS----------------------TT----SS------------S-S-------------------------------------------SS--------------------SS--------------------------------
------------------------------TT------------------------------------------------------------TT------------------------------------------------------------------------------------------------------------------------
-----SS-----------------------TT-----------------------#--------------------------S---------X-------------------------------TT-----------------SSX--TT--------------------SSS---------------------------------S-------
------------------------------XT----------------------##--------------------------------------------------------------------TT----------T-----------TT----------------------------------------------------------------
-------------------------------X-------------S-------#-#---#-----S----TT-##-TT-------------SSS----SS------------------------XX----TT--#-TT--#-------XX-----TT-------tt-------------S------------------TT--------------
------------------TT----TT-----------------------TTT#------#----------TT-##-TT------TT----------------TT------------TT-T----------TT-##-TT-#---------------TT-------t------------------------------#--TT--------TT----
----------------TT------TT--------TT-#----------TTTT##-----#----------TT-##-TT------TT----------------TT------------TTTT----------TT-##-TT--#--T-----------TT-------t--TT-TT----------------------##--TT--------TT----
----------------TT-------T--------TT-#----------TTTT##----##----------TT-##-TT------TT--------------k-TT------TT----TTTT----------TT-##-TT-##--T-----------TT-------t--TTTTT---------------------##---TT-----k--TT-#--
------XXXXXXXXXXXXXXXXXXXXXXXXXXXXXXXXXXXXXXXXXXXXXXXXXXXXXXXXXXXXXXXXXXXXX-XXXXXXXXXXXXXXXXXXXXXXXXXXXXXXXXXXXXXXXXXXXXXXXXXXXXXXXXXXX-XXXXXXXXXXXXXXXXXXXXXXXXXXXXXXXXXXXXXXXXXXXXXXXXXXXXXXXXXXXXXXXXXXXXXXXXXXXXXX
------XXXXXXXXXXXXXXXXXXXXXXXXXXXXXXXXXXXXXXXXXXXXXXXXXXXXXXXXXXXXXXXXXXXXXXXXXXXXXXXXXXXXXXXXXXXXXXXXXXXXXXXXXXXXXXXXXXXXXXXXXXXXXXXXX-XXXXXXXXXXXXXXXXXXXXXXXXXXXXXXXXXXXXXXXXXXXXXXXXXXXXXXXXXXXXXXXXXXXXXXXXXXXXXX