----------------------------------------------------------------------------------------------------------------------------------------------------------------------------------------------------------------------
----------------------------------------------------------------------------------------------------------------------------------------------------------------------------------------------------------------------
----------------------------------------------------------------------------------------------------------------------------------------------------------------------------------------------------------------------
----------------------------------------------------------------------------------------------------------------------------------------------------------------------------------------------------------------------
----------------------------------------------------------------------------------------------------------------------------------------------------------------------------------------------------------------------
----------------------------------------------------------------------------------------------------------------------------------------------------------------------------------------------------------------------
--------------------SSS----------------------------------------##---------------------------------TT------------------------------------TT-------------------SSSS-----------------------------------------------------
--------------------------------------------TT----------------###---------------------------------TT------------------------------------TT----------------------------------------------------------------------------
--------------------------------TT----------TT---------------#####--------------------------------TT------------------------------------TT---------------------------SS-----SSSS---SSS--------------------------------
--------------------------------TT----------TT--------------######--------------------------------TT----------------------------------#-------------------------------------------------------------------------------
-----------SS-----TT----------T-TT-------T--TT------TT----TT######--------------------------------T----TTT----TT---------------------##-------TT---S--TT-----S---SS-----------------------------------------T---SS----
------------------TT----------TTTT----TTTT--TT------TT----TT######------TT----TTT-------TTTT--TT-------TTT----TT----------------TT--T##-----TT--------TT------------------TT--------------------------TT----T---------
----TT----TT---T--TT-----tt-TTTTT-----TTT----T------TT---#TT######---#--TT----TTT-------TTTT--TT-------TTT----TT----------------TT-TT##-TT--TT--------TT------------------TT--------TT----TT----TT----TT----T---------
-----T----TT---T--TT-----tt-TTTT------TT-----T---k--TT---#TT######---#--TT----TTT-------TTTT--TT-------TTT----TT----------------TT--T##-TT--TT--------TT------------------TT-----#--TT----TT----TT----TT-------t------
XXXXXXXXXXXXXXXXXXXXXXXXXXXXXXXXXXXXXXXXXXXXXXXXXXXXXXXXXXXXXXXXXXXXXXXXXXXXXXXXXXXXXXXXXXXXXXXXXXXXXXXXXXXXXXXXXXXXXXXXXX-----XXXXXXXXXXXXXXXXXXXXXXXXXXXXXXXXXXXXXXXXXXXXXXXXXXXXXXXXXXXXXXXXXXXXXXXXXXXXXXXXXXXXX--
XXXXXXXXXXXXXXXXXXXXXXXXXXXXXXXXXXXXXXXXXXXXXXXXXXXXXXXXXXXXXXXXXXXXXXXXXXXXXXXXXXXXXXXXXXXXXXXXXXXXXXXXXXXXXXXXXXXXXXXXXX------XXXXXXXXXXXXXXXXXXXXXXXXXXXXXXXXXX-XXXXXXXXXXXXXXXXXXXXXXXXXXXXXXXXXXXXXXXXXXXXXXXXX-X