----------------------------------------------------------------------------------------------------------------------------------------------------------------------------------------------------------------------
----------------------------------------------------------------------------------------------------------------------------------------------------------------------------------------------------------------------
----------------------------------------------------------------------------------------------------------------------------------------------------------------------------------------------------------------------
----------------------------------------------------------------------------------------------------------------------------------------------------------------------------------------------------------------------
----------------------------------------------------------------------------------------------------------------------------------------------------------------------------------------------------------------------
------------------------------------------------------------------------------------------k---------------------------------------------------------------------------------------------------------------------------
----------T---S-------##-------S----------SSS---------------------------------------TT----SSSSS------------------SSS----------SSSS--------SS-----------SSS--SC----------TT--TT--------------------------------SS------
---------------------###------------------------------------------------------------TT----------------------------------------------------------------------------------T---TT----------------------------------------
--------------------####------------------------SSSS-----------------------##-------XX------------------------------------------------T---------------------------------X---------------------------------------------
------------------TT####-------------------------------------------------####---------------------------------------------------------T-------------------------------------------------------------------------------
------S------S----TT##---------S-------------------------------S--------#####---#---TT------------------TT--------------------2S------XX------------------------------------SS------T-----------TT---S---T------------
-----------------TTT##----TT-------------------------------------------######---#---TT------------------TT----------------TT------TT----------------------------------TT------------T-----------TT-------T------------
----------------TTT-##--#-TT------ttTT--TT----------TT------TT--##----#######---#---TT----------TT--TT------------------TTTT------TT----------TT----------------------TT------------TT----TT----TT------TT------TT----
--------------k-TT--##--#-TT------ttTT--TT----------TT------TT--##----#######---#---TT-------k--TT--TT------------------TTTT----k-TT---t---T--TT----------------------TT------------TT----TT----TT------TT------TT----
XXXXXXXXXXXXXXXXXXXXXXXXXXXXXXXXXXXXXXXXXXXXXXXXXXXXXX----XXXXXXXXXXXXXXXXXXXXXXXXXXXXXXXXXXXXXXXXXXXXXXXXXXXX--XX--XXXXXXXXXXXXXXXXXXXXXXXXXXXXXXXXXXXXX-XXXXXXXXXXX-XXXXXXXXXXXXXXXXXXXXXXXXXXXXXXXXXXXXXXXXXXXXXX--
XXXXXXXXXXXXXXXXXXXXXXXXXXXXXXXXXXXXXXXXXXXXXXXXXXXXXX----XXXXXXXXXXXXXXXXXXXXXXXXXXXXXXXXXXXXXXXXXXXXXXXXXXXX------XXXXXXXXXXXXXXXXXXXXXXXXXXXXXXXXXXXXX-XXXXXXXXXX--XXXXXXXXXXXXXXXXXXXXXXXXXXXXXXXXXXXXXXXXXXXXXX-X