----------------------------------------------------------------------------------------------------------------------------------------------------------------------------------------------------------------------
----------------------------------------------------------------------------------------------------------------------------------------------------------------------------------------------------------------------
----------------------------------------------------------------------------------------------------------------------------------------------------------------------------------------------------------------------
----------------------------------------------------------------------------------------------------------------------------------------------------------------------------------------------------------------------
----------------------------------------------------------------------------------------------------------------------------------------------------------------------------------------------------------------------
----------------------------------------------------------------------------------------------------------------------------------------------------------------k-----------------------------------------------------
----------------------------------------------------------SSSS--------------------------------------SSSSSSSSS-------------SS-----SSSS---------------------------S-----------------------------------------------------
------------------------------------------------------------------------------------------------TT--------------------------------------------------------------------------------------------------------------------
--------------S------S-------------------------------------------------SS-------------SS--------SX------------------------------------------------------TTT-----------------------------SS----------------------T-----
----------TT--------------------------------------------------------------------------------------------------------------------------------------------TTT-----------------------------------------------------T-----
----------TT------S--------t------------TT--------TT--SX------------------------S--------------------------------------T------------TT------------------XXXSS-----------------TT--------------------##----------XX----
----------TT--------TT----tt-------T----TT--------TT----------------------------------------TT------------------------TT------------TT-----TTT--------T-----------------------TT----TT-------------#--T---T-----------
--TT------TT--------TT-----t------TT----TT--------TT------------TT--------------------------TT--------------------------------------TT----TTTT--------TT--------------------T-TT--T-TT----tt---TT-#-##----TT----------
--TT----#-TT--------TT-----t------TT----TT-----k--TT------------TT--------------------------TT--------------------------------------TT----TTTT--------TT--------------------T-TT--T-TT-----t---TT--###--#-TT-------#--
XXXXXXXXX-XXXXXXXXXXXXXXXXXXXXXXXXXXXXXXXXXXXXXXXXXXXXXXXXXXXXXXXXXXXXXXXXXXXXXXXXXXXXXXXXXXXXXXXX--------XXXXXXXXXXXXXXXXXXXXXXXXXXXXXXXXXXXXXXXXXXXXXXXXXXXXXXXXXXXXX---XXXXXXXXXXXXXXXXXXXXXXXXXXXXXXXXXXXXXXXXXXXX
XXXXXXXXX-XXXXXXXXXXXXXXXXXXXXXXXXXXXXXXXXXXXXXXXXXXXXXXXXXXXXXXXXXXXXXXXXXXXXXXXXXXXXXXXXXXXXXXXX--------XXXXXXXXXXXXXXXXXXXXXXXXXXXXXXXXXXXXXXXXXXXXXXXXXXXXXXXXXXXXX---XXXXXXXXXXXXXXXXXXXXXXXXXXXXXXXXXXXXXXXXXXXX