----------------------------------------------------------------------------------------------------------------------------------------------------------------------------------------------------------------------
----------------------------------------------------------------------------------------------------------------------------------------------------------------------------------------------------------------------
----------------------------------------------------------------------------------------------------------------------------------------------------------------------------------------------------------------------
----------------------------------------------------------------------------------------------------------------------------------------------------------------------------------------------------------------------
----------------------------------------------------------------------------------------------------------------------------------------------------------------------------------------------------------------------
----------------------------------------------------------------------------------------------------------------------------------------------------------------------------------------------------------------------
--------------------SS------------------------------SSS--------------------------T-------------------------------SSS----------------SS--------------------------TT----------------------------------------------------
--------------------------------------------------------------------------------TT------------------------------------------------------------------------------TT----------------------------------------------------
----------##----------------TT-------------------------------------------------------------------SSSSS--------------------------------------------------TT--------------------------------------------------SS--------
---------###------------TT------------------------------------------------------------------------------------------------------------------------------TT------------------------------------------------------------
--------###-------------TT----------TT-----t-------------------------tt-----TT----tt--TT------T--------tt--T-S------SSS---SS----------TT----------------TT--------SS----------------TT------TT----TT------------------
-------#####------------TT----------TT-----t------T------------------t------TT--------TT------T-----------TT--------------------------TT--------TT------TT--------------TT----------TT------TT----TT------------------
------#####-----------TTTT------TT----------------T-----------TT-------t----TT--------TT-----TTT--TT------TT--------------------------TT--------TT------TT--TT----------TT---TT-----TT------TT----TT------------------
-----#####------------TTTT------TT----------------T---TT------TT------------TT------k-TT-----TTT--TT----T-TT-------k----------TT----k-TT--------TT------T---TT------k---TT----T---k-TT------TT----TT-----------k------
XXXXXXXXXXXXXXXXXXXXXXXXXXXXXXXXXXXXXXXXXXXXXXXXXXXXXXXXXXXX------XXXXXXXXXXXXXXXXXXXXXXXXXXXXXXXXXXXXXXXXXXXXXXXXXXXXXXXXXXXXXXX---XXXXXXXXXXXXXXXXXXXXXXXXXXXX--XXXXXXXXXXXXXXXXXXXXXXXXXXXXXXXXXXXXXXXXXXXXXXXXX---
XXXXXXXXXXXXXXXXXXXXXXXXXXXXXXXXXXXXXXXXXXXXXXXXXXXXXXXXXXXX------XXXXXXXXXXXXXXXXXXXXXXXXXXXXXXXXXXXXXXXXXXXXXXXXXXXXXXXXXXXXXX----XXXXXXXXXXXXXXXXXXXXXXXXXXXX--XXXXXXXXXXXXXXXXXXXXXXXXXXXXXXXXXXXXXXXXXXXXXXXXX---