----------------------------------------------------------------------------------------------------------------------------------------------------------------------------------------------------------------------
----------------------------------------------------------------------------------------------------------------------------------------------------------------------------------------------------------------------
----------------------------------------------------------------------------------------------------------------------------------------------------------------------------------------------------------------------
----------------------------------------------------------------------------------------------------------------------------------------------------------------------------------------------------------------------
----------------------------------------------------------------------------------------------------------------------------------------------------------------------------------------------------------------------
----------------------k-----------------------------------------------------------------------------------------------------------------------------------------------------------------------------------------------
------------------TT--SSSS----S-----#-----------------------------------TT--------------------------------SS-------SSS------TT----------------------S----------------------------------------------SSSS---------------
------------------TT---------------####----------------------------------T--------------------------------------------------TT----------------------------------------------------------------------------------------
------------------TT--------------#####----------------SS-------------------------TT-------------SS-----------SSS-----------XX------------------TT------------------------------TT----SSS-----------------------------
-----------#------TT---------#---######-------------------------------------------TT------------------------------------------------------------TT------------------------------TT------------------------------------
----------##------XX--------##--T######-------TT--------------TT----SS------------XX------TT-----------------------------------------SS-----------------------------TT------TT---XSSSX--------------------------------
--------TT---------------#TT-#-TT######---TT--TT--------------TT--------------TT---T------TT-------T----------------------------T-----------------------------------TT-----TTT----------------TT----------------------
--------T-##TT----------##TT-#--########--TT--TT------------T-TT-T------------TT---T------TT--TT---T--TT------TT----------------TT-----tt---------------------------TT---TTTTT----------------TT------------TT--------
-------#T###TT---------###TT-#--########--TT--TT------------TTTT-T------------TT--TT---k--TT--TT------TT------TT----------------TT-----t----------------------------TT---TTTTT----------------TT------------TT--------
XXXXXXXXXXXXXXXXXXXXXXXXXXXXXXXXXXXXXXXXXXXXXXXXXXXXXXXXXXXXXXXXXXXXXXXX----XXXXXXXXXXXXXXXXXXXXXXXXXXXXXX--XXXXXXXXXX----XX--XXXXXXXXXXXXXXXXXXXXXXXXXXXXXXXXXXXXXXXXXXXXXXXXXXXXXXXXXXXXXXXXXXXXXXXXXXXXXXXXXXXXXX--
XXXXXXXXXXXXXXXXXXXXXXXXXXXXXXXXXXXXXXXXXXXXXXXXXXXXXXXXXXXXXXXXXXXXXXXX-----XXXXXXXXXXXXXXXXXXXXXXXXXXXXX--XXXXXXXXX---------XXXXXXXXXXXXXXXXXXXXXXXXXXXXXXXXXXXXXXXXXXXXXXXXXXXXXXXXXXXXXXXXXXXXXXXXXXXXXXXXXXXXXX-X