----------------------------------------------------------------------------------------------------------------------------------------------------------------------------------------------------------------------
----------------------------------------------------------------------------------------------------------------------------------------------------------------------------------------------------------------------
----------------------------------------------------------------------------------------------------------------------------------------------------------------------------------------------------------------------
----------------------------------------------------------------------------------------------------------------------------------------------------------------------------------------------------------------------
----------------------------------------------------------------------------------------------------------------------------------------------------------------------------------------------------------------------
--------------------------k-------------------------------------------------------------------------------------------------------------------------------------------------------------------------------------------
---------------------#----S----------S----------##---#----------------------------SSTT----------------------SS-------------------SS-----------------------------------------------------------------------------------
-----------------------------------------------#-#---##-#-------------------------------------------------------------------------------------------------------------------------------------------------------------
---------------------#------------S------------#-#--###-#--------------------------------------SS-----------------------------------------------------------SSSS--------------------SS--------------------------------
---------------------#-------------------------###-####-#-------------------------------------------------------------------------------------------------------------------------------------------------------------
---S----TT-----T------------SSSS----------TT--##-#-####-#-----------------------TT---2-----SS-----TT-SSS-----SSS------TT-------tt-----------T---S-------------------------------TT------XX----------------TT----TT----
--------TT----TT--------------------------TT-T---#-####-#-----------------------TT----------------TT------------------TT-------t----TT------TT--------TT--------------------------------------------------TT----TT----
------TTTT----TT--------------------------TT---###-######-----------------TT----TT----TT----------TT------------------TT------------TT-----TTT--------TT-------------T------TT--#---TT--------------------TT----TT----
------TTTT----TT-----------------------k-TTT-##########-------------------TT----TT----TT-------k--TT------------------TT-------t----TT-----TTT-----k--TT-------------T------TT------TT-------T------------TT----TT----
XXXXXXXXXXXXXXXXXXXXXXXXXXXXXXXXXXXXXXXXXXXXXXXXXXXXXXXXXXXXXX--XXXXXXXXXXXXXXXXXXXXXXXXXXXXXXXXXXXXXXXXXXXXXXXXXXXXXXXXXXXXXXXXXXXXXXXXXXXXXXXXXXXXXXXXXXXXXXXXXXXXXXXXXXXXXXXXXXXXXXXXXXXXXXXXXXXXXXXXXXXXXXXXXXXXXX
XXXXXXXXXXXXXXXXXXXXXXXXXXXXXXXXXXXXXXXXXXXXXXXXXXXXXXXXXXXXXX--XXXXXXXXXXXXXXXXXXXXXXXXXXXXXXXXXXXXXXXXXXXXXXXXXXXXXXXXXXXXXXXXXXXXXXXXXXXXXXXXXXXXXXXXXXXXXXXXXXXXXXXXXXXXXXXXXXXXXXXXXXXXXXXXXXXXXXXXXXXXXXXXXXXXXX