----------------------------------------------------------------------------------------------------------------------------------------------------------------------------------------------------------------------
----------------------------------------------------------------------------------------------------------------------------------------------------------------------------------------------------------------------
----------------------------------------------------------------------------------------------------------------------------------------------------------------------------------------------------------------------
----------------------------------------------------------------------------------------------------------------------------------------------------------------------------------------------------------------------
------------------------------------------------------------------------------------------------------S---------------------------------------------------------------------------------------------------------------
----------------------------------------------------------------------------------------------------------------------------------------------------------------------------------------------------------------------
--SS--SS--------------SS-------------------S--SSSSSSS--------#--#------------------------------S----------SS------------------------------------------------------SS--------------------------S-----------------------
------------------------------------------------------------##--#----------------------------------------------------------------------------------------T------------------------------------------------------------
--------------TT-----------------------------------------------##--------------------------------------------SSSSSSS-----#---#--------------------------TT--------##---------------------------------#----------SS----
--------------TT---------------------------------------------####--------------------------------------------------------#--##-----------------------------------###--------------------------------#-----------------
------SSS-----XX----------------S--tt--------------T---------####------------------------------------------------------T---#--------SX-S-S----TT------SX-------#--#--S-------T--------------------TT-#-----t----------
------------------------------------t-------------TT--------####------TT----------------TT------------TT--------------T-----#-----------------TTT----------------------------T--------------------TT-#----tt----------
--------------------------TT----------------------TT-----t-#TT##------TT------T---TT--TTTT----#-------TT---------------T-####-TT--------------TTT----------T------#-----------TT------TT----------TT-#----tt----------
--------------------------TT--------t-------------TT-----t-#TT##----k-TT------TT--TT--T-TT---##-------TT---------------T#####-TT------------k--TT----------T------##-------k--TT------T-----------TT-T----tt-------#--
-----XXXXXXXXXXXXXXXXXXXXXXXXXXXXXXXXXXXXXXXXXXXXXXXXXXXXXXXXXXXXXXXXXXXXXXXXXXXXXXXXXXXXXXXXXXXXXXXXXXXXXXXXX----XXXXXXXXXXX-XXXXXXXXXXXXXXXXXXXXXXXXXXXXXXXXXXXXXXXXXXXXXXXXXXXXXXXXXXXXXXXXXXXXXXXXXXXXXXXXXXXXXXXX
-----XXXXXXXXXXXXXXXXXXXXXXXXXXXXXXXXXXXXXXXXXXXXXXXXXXXXXXXXXXXXXXXXXXXXXXXXXXXXXXXXXXXXXXXXXXXXXXXXXXXXXXXXX----XXXXXXXXXXXXXXXXXXXXXXXXXXXXXXXXXXXXXXXXXXXXXXXXXXXXXXXXXXXXXXXXXXXXXXXXXXXXXXXXXXXXXXXXXXXXXXXXXXXX