----------------------------------------------------------------------------------------------------------------------------------------------------------------------------------------------------------------------
----------------------------------------------------------------------------------------------------------------------------------------------------------------------------------------------------------------------
----------------------------------------------------------------------------------------------------------------------------------------------------------------------------------------------------------------------
----------------------------------------------------------------------------------------------------------------------------------------------------------------------------------------------------------------------
----------------------------------------------------------------------------------------------------------------------------------------------------------------------------------------------------------------------
---------------------------------------------------------------------------------------------------#------------------------------------------------------------------------------------------------------------------
----------------------------------------------------TT--SS-----SS-------------------TT-----------------S-SSSSSSSSSS---------------------SSSSSS------------SS------------TT--------------------------------------------
----------------------------------------------------TT------------------------------TT------TTT-------------------------------------------------------------------------TT---------------------------#----------------
------SS-------SSSSSS------------------------------XXX------------------------------TT--S----TT-----------------------------------------------------TT------------------XX----------S---SSSSS-------##----SS----------
------------------------------------------------------------------------------------XX-------TT-----------------------------------------------------TT-------------------------------------------#-###----------------
-----------SS---------------------------------------------TT---S----TT-----------------------XXXS----SSSSSS---------------------------------------TT------TT------tt----------------------------##-###---------SSS----
--------------------------TT-----------------------------TTT--------TT------TT-----------T----------------------------T---TT------TT--------------TT------TT------t------------T---------------#-#T#-#----------------
--------------------------TT------TT--------TT----------TTTT--------TT----TTTT-TT-------TT----------------------------TT--TT------TT------TT------TT----T-TT--------TT-----T--TT-----------------#--##----------------
--------------------------TT------TT--------TT--------k-TTTT--------TT----TTTT-TTT------TT------------##--------------TT--TT------TT------TT------TT----T-TT--------TT--#-----TT--------------##-----#---#---------#--
----XXXXXXXXXXXXXX------XXXXXXXXXXXXXXXXXXXXXXXXXXXXXXXXXXXXXXXXXXXXXXXXXXXXXXXXXXXXXXXXXXXXXXXXXXXXXXXXXXXXXXXX------XXXXXXXXXXXXXXXXXXXXXXXXXXXXXXXXXXXXXXXXXXXXXXXXXXXXXXXXXXXXXXXXXXXXXXXXXXXXXXXXXXXXXXXXXXXXXXXX
----XXXXXXXXXXXXXX------XXXXXXXXXXXXXX---XXXXXXXXXXXXXXXXXXXXXXXXXXXXXXXXXXXXXXXXXXXXXXXXXXXXXXXXXXXXXXXXXXXXXXX------XXXXXXXXXXXXXXXXXXXXXXXXXXXXXXXXXXXXXXXXXXXXXXXXXXXXXXXXXXXXXXXXXXXXXXXXXXXXXXXXXXXXXXXXXXXXXXXX