------------------------------------------------------------------------------------------------------------------------------------------------------
------------------------------------------------------------------------------------------------------------------------------------------------------
------------------------------------------------------------------------------------------------------------------------------------------------------
------------------------------------------------------------------------------------------------------------------------------------------------------
------------------------------------------------------------------------------------------------------------------------------------------------------
------------------------%-%%%-----------oo--------------------oo-----------------------o-------------------------------%%%%---------------------------
-----------------%%%%%%%---|-----------------------------------------------------g------------------------%%%%%-----SS--||--------------------|-------
------------------||||||---|---------------------#-----------------------------%%%%%------o----------------|||----------||---------------S------------
------------------||||||---|-------S------------#%%%%-------%%%-----------------|||--------------------S--||||----------||--------------SS------------
------------------||||||------------------------#|||--------||----------or------||---------------------S--||||----------||%%%%%-----------------------
-%%%%-----%%%%%---||||||---------------------#--|-||--------||---------%%%%%%-%%|%%%%----%%%%%------------||||----------||||||--%%%-------------------
--||--------||----|||||----------------------#--|-||--------||----------||||--||||||--%---|||-------------||||---%%%%---||||||--||--------------------
--||--------||----|||||----------------------#--|-||--------||----------||||--||||||--|---||----------%%%%||||----||----||||||--||--------------------
--||----oo--||----|||||----------------#-----#----||--------||----------||||--||||||--||--||-----------|--||||----||----||||||--||-----------------#--
--||----%%%-||--%%|||||--%%%---XXXXXXXXXXXXXXXX-||||--XXXXXXXXXXXXXXXX--||||--||||||--||--||--------XXX|||||||----||----||||||--|||---XXXXXXXXXXXXXXXX
--||-----|-|||--XX||||----|----XXXXXXXXXXXXXXXX-||||--XXXXXXXXXXXXXXX---||||---|||||--||--||-------XXXX|||||||----||----||||||--||||-XXXXXXXXXXXXXXXXX