------------------------------------------------------------------------------------------------------------------------------------------------------
------------------------------------------------------------------------------------------------------------------------------------------------------
------------------------------------------------------------------------------------------------------------------------------------------------------
-----------------------oo-----------------------------------------------------------------------------------------------------------------------------
-------------------------XXg||------------------------------------------------------------------------------------------------------------------------
---R--ooo------------------%%%%%%%------oo------------------------------------oo--------------------------oo--oo--------------------------------------
-----%%%%--------%%%--------|||||------%%%%----------------------------------------------------g-----------%%%%%-----------#%##-----------------------
------||--------------------|||||-------||--oooo------------oooo----------------------------%%-g--oo--------|||||---------#####-----------------------
------||-----####-----------|||||-------||-%%%%%%-------------%%%%%------------------------#----------oo----||||||-------######-----------------------
------||-----####-----------||||||------||--||||---------------||||-------oo---------------#----------------||||||-------######-----------------------
------||---######-------SS--||||||--%%%%%%--||||---------------|||||--%%%%%--------------###--------------%%||||||------#######--%%%%--#--------------
------||--#######-----------||||||---|||||--||||---------------|||||--||||---------------###----------------||||||------#######---||--##--------------
------||--######------------||||||---|||-|--||||------------%%%%||||--||||-------------#####----------------||||||-|----######----||---#--------------
------||--######------------||||||--||||----||||-----%------%|||||||--||||--------------####---%%%%%-------|||||||||-----#####----||--||--------------
----%|||XXXXXXXXXXXXXX------||||||---|||----||||-----|-------|||||||--%|||--------XXXXXXXXXXXXX---|--------|||||||||--XXXXXXXXXXX-||X-|XXXXXXXXXXXXXXX
----||||XXXXXXXXXXXXX-------||||||---|||----||||------------||||||||--||||--------XXXXXXXXXXXXX------------|||||||||--XXXXXXXXXXX-||--||XXXXXXXXXXXXXX