------------------------------------------------------------------------------------------------------------------------------------------------------
------------------------------------------------------------------------------------------------------------------------------------------------------
------------------------------------------------------------------------------------------------------------------------------------------------------
------------------------------------------------------------------------------------------------------------------------------------------------------
------------------------------------------------------------------------------------------------------------------------------------------------------
----------------------------------------------------------------------------oo---------------------------------------------oo----o------oo------------
------------------------------------------------------------------------------------------------------------------------------------------------oo----
------------------oo-----------------o-------------------------ooo-------------------------------------%----------------------------------------------
-----------------%-%%----------------------------------------------------------------S--|----------%%%%%-----#-------oo-----SS------------------------
------------------||--------------------------------------------------------------------|-----------||||-----#-----------------------------------#----
------------------||------------SS------------%%-------------------------SSSS-----------%%%--%%%%---||||-----#---------------%%%%--------%%%%----#----
------------------||--------------------------|----#------#-----------------------------||----||----||||-----#----------------||----%%----|-----##----
--------%%%%%-----||----------------%---------|----#------------------------------------||----||----||||----------------------||----||----|----###----
--------||||------||----------------||--------------------#-|-%------------------%%%%---||----||----||||-----------%%%%%---%%-||----||----||----##-#--
XXXXX---||||----%-||X-XXXXXX--XX----|%------%%%%%-XXXXXXXXX-||-----%%%------XXX--X|-----||----||----||||--XXXXX-X---||------|-||----||----||XXXXXXXXXX
XXXXX---||||-----|||--XXXX---XXX----||--------||-XXXXXXXXXX-||------|-------XXXX--||----||----||----||||--XXXXX-----||--------||----||----||XXXXXXXXXX