------------------------------------------------------------------------------------------------------------------------------------------------------
------------------------------------------------------------------------------------------------------------------------------------------------------
------------------------------------------------------------------------------------------------------------------------------------------------------
-------------------------------oo---------------------------------------------------------------------------------------------------------------------
-----------------------------------g---------------------|-|------------------------------------------------------------------------------------------
-------------%%%%-------o--------%%%%--%---------------%%%%%%------------ooo--------------oo--o--------o---oo-----------------------------------------
--------------||-------------------|--------------%%%---||||----------------------------------------------------------------------oo------------------
--------------|---oo-----%%%%%-----|--------------||----||||---------------------------------------------------%%%%%%-oo--oo--------------------------
----------SS--|-----------||||-----##-------------||----||||----------------------------------------------------||||----------------------------------
--------------||----------||-|----###----------%%-||----||||---------#------------------------------------------||||--|%------------------------------
-------------%%%%%%--%%%%-||||---####-------%%%||-||----||||-----#####-------------------%SS---------%%%%%%---%-||||--||-------------%%%%---SS--------
--------------||||----|||||||---######-------|-|||||----||||-----####---------------------------------||||------||||--|---------------||--------------
--------------||||----||||||||-######--------%||||||||--||-|----######--------------------------------||-|-----|||||------------------||--------------
X-------------||||----||||||||-######--------|||||||||--||------######----------oooooo----------------||-|--||-|||||--|---%%o%--------||--------------
XXXXXXXXXX--%-||||--%%%|||||||-XXXXXXX-X%---|-||||||||--||XXXXXXXXXXXXX--------%%%%%%-----------%%----||----||-|||||------|-|%---%%%--||-----------%%%
XXXXXXXXXX----||||--||-|||||||-XXXXXXX-%|-----||||||||--||XXXXXXXXXXXXX---------||||------------|-----||----||-|--||--------||----|---||------------X-