------------------------------------------------------------------------------------------------------------------------------------------------------
------------------------------------------------------------------------------------------------------------------------------------------------------
------------------------------------------------------------------------------------------------------------------------------------------------------
-------------------------------------------------------R----------------------------------------------------------------------------------------------
---------------------------------------------------------------%%%%-----------------------------------------------------------------------------------
--------ooooo--%%%%%%---------------oo------oo-----------%%%----||----------------------oo----------------oo---------------------------------o--------
--------%%%%%---||||--------------------------------------|-----||---------------------------------%%%%-------------%%%%------------------------------
----------||----||||--------------------------------------||----||----------------------------------||----------------------------------o-------------
--------||||----||||-----------------------------------%%%|%----||----------------------------oo----||------------------------------------------------
---------|-o-oo-||------------oo-----------------------#--||----||--##------------------------------||-----------------------------------SS-----------
-------%%%%--%%%||------o------------------%%%-----#-#-#--||-----|-###---------------------------%%%%%---%--S------------------%%%%%---------%%%%-----
--------||----||||--------------------------|------#####--||-------###----------------------------|-||--------------------------||------------||------
--------||----||||--------------------------|------#####--||-----#####----------------------------|-||--------------------------||------------||------
--------||---|||||---------------------------------######--|-----#####-------------------------%%%%|||--------------------------||------------||---#--
------%-||---|||||--XX-XX----%%%%%%%%%%---%%%---XXXXXXXXXXXXXXXXXXXXXXXXXXXXXXX-----%%----%%-----|-|||--------XXXXXXXXXXXXXXXX--||----XX---%%-|XXXXXXX
------|-||--||||||-----------%%%%%%%|------|----XXXXXXXXXXXXXXXXXXXXXXXXXXXXXXX%----------|------|-|||--------XXXXXXXXXXXXXXX---||----XXX--|--||XXXXXX