------------------------------------------------------------------------------------------------------------------------------------------------------
------------------------------------------------------------------------------------------------------------------------------------------------------
------------------------------------------------------------------------------------------------------------------------------------------------------
------------------------------------------------------------------------------------------------------------------------------------------------------
-------------------------------------------------------------------------------------------------X-------------------------X--------------------------
--------------------oo------------------------------------------ooo%%%--------o------------------XX%%%%------o-----------%%%%-------------------------
------------------------------------------oo-------------------%%%%%|-------------SS----------------||---------------------|--------------------------
----------------------------------------------------------------||||-------------S------------------||----------oo---------|--------------------------
---------------------------------S%S---------------------|--||--||||-----------------------%%%%%%%%%%%%---------%%%%%------|--------------SSS---------
---------o--oo----------oo-------|---------------------%%%%%||--||||----------------------##|||||||-||-----------|||-------|--------------------------
-------%%%%-%%%%%--%%%%--%%%%---------SS----%%%%%-------||||||--||||----SS---------#-%%%##--||||||--||-----SS-----||-------|-SSS----------------------
--------||---|||-----|----||-----------------|||%-------||||||--||||--------|------########-|||||||-||------------||-------|--------------------------
--------||---|||-----|----||------------------||--------||||||--||||--------||-----########-||||||--||---------#--||----------------------------------
--------||---|||-%o%-|----||--------oo----oo--||--------||||||--||||--------||-----########-||||||--||---------#--||----------------oo--%%%--------#--
XXXXXX%%%%%%%%%|--|--|---%||--X%%%--%%%%%%%%--||--------||||||-|||||XXXXXXXXXXX-XXXXXXXXXXX-|||||||-||---------%%XXXXXXXXXXXXXXXXX-X%%--|XX-XXXXXXXXXX
XXXX-%-|||-%%|||--|-||---|||--XX|----|%%-%----||--------|||||||||||XXXXXXXXX||XXXXXXXXXXXXX-||||||--||---------|--|XXXXXXXXXXXXXX---||--||-XXXXXXXXXXX