------------------------------------------------------------------------------------------------------------------------------------------------------
------------------------------------------------------------------------------------------------------------------------------------------------------
------------------------------------------------------------------------------------------------------------------------------------------------------
------------------------------------------------------------------------------------------------o-----------------------------------------------------
-----------------------------------------------------------------------------------------------------g------------------------------------------------
-------------------------------------------------R---ooo----------------------------------oo-------%%%%%%---------------------------------------------
----------------###%%##%---------------------------%%%%%%-------------------------------------------|||-----------------------------------------------
----------------########--------ooo-----------------||||-----------------------------------|--------|||-----------------------------------------#-----
-----g-------###########----------------------------|||||------%%%%%SS-----##%---------%--|%---%%%-|||------------------o------------------SS--##-----
---%%%%%-----#############-------%%%%---------------|||||-------|||--------###---#----#---||----||%%||-----%%%%-------------o------------------##-----
----|||----###############--------|||%%---%%%%%-%%%%||||||------|||------######-##--#-----||----||||||------||-----------%%%%----------------####-----
----||-----###############--------||||-----|||---||-||||||------||-------#########--------||----||||||------||-------------|----------------#####-----
----||-----###############-%%%%---||||-----|||--||--||||||------||-------########---------|%%---||||||------||--%%%%%-----||-----------------####-----
----||-----##############---||----||||-----|||--||--||||||------||-------######-----------||----||||||--oo--||--||||%--%%%%|-----------------####--#--
----||--XXXXXXXXXXXXXXXXX---||--%-||||---%%|||--||--||||||----XXXXXXXXXXXXXXXXXXXXXXXXX---||----||||||--%%%-||--||||----||||----%%%%-XXXXXXXXXXXXXXXXX
----||---XXXXXXXXXXXXXXX----||----||||-----|||--||--||||||----XXXXXXXXXXXXXXXXXXXXXXXXX---||----||||||--||--||--||||----||-------%%%--XXXXXXXXXXXXXXXX