------------------------------------------------------------------------------------------------------------------------------------------------------
------------------------------------------------------------------------------------------------------------------------------------------------------
------------------------------------------------------------------------------------------------------------------------------------------------------
------------------------------------------------------------------------------------------------------------------------------------------------------
---------------------------------------X-X------------------------------------------------------------------------------------------------------------
--------------------------------------oo-X----------oo------------------------ooo-----oo--------------------------------------------------------------
---------------------------SS----------------------%%%%----------------------%%%%----------------------------------------------------------#----------
-----------------oo---------------------------------||------------------------||-------------------o---------------------------------------#----------
---------------%%%%%%%------------------------------||-----%%%%%%-------------||-------------------%%--------------------------------------#-----oo---
----------------||||----------#------------------oo-||------|||---------------||-------------------|------%%------------------------oo-----#----------
----------------||||---------##-----oo----------%%%%%|------|||-----------SS---|-------------SS----|------||-----%%----------------%%%%%--------------
----------------||||--------###------------------|||||------||-------------------------------------|------||------|-%---------------||----------------
-------------%%%%%|--------#####--------%%-------|||||------||-----------------------------------%%%%%%---||------------------------||----------------
--------------|||||--------####---------%%%------|||||------||--%%%%%%%-||-%%-o-----------oo------||||----||------%%%-------------o-||-------------#--
X--XXXXXXX----|||||----XXXXXXXXXXXXX----||------%|||||-XXXXX||---|--||--||--||%-------%%-%%%%%----||||----||----%%||--o%-%%%------%-||--XXXXXXXXXXXXXX
X----XXX------||-------XXXXXXXXXXXXX----||-------|||||XXXXX-||---|--||--||--||--------%---|-------||||----||------||----------------||--XXXXXXXXXXXXXX