------------------------------------------------------------------------------------------------------------------------------------------------------
------------------------------------------------------------------------------------------------------------------------------------------------------
------------------------------------------------------------------------------------------------------------------------------------------------------
------------------------------------------------------------------------------------------------------------------------------------------------------
------------------------------------------------------------------------------------------------------------------------------------------------------
--------------------------oo---------------R----oooo----%--------o---------------R----oo--oo------------------------------------oo--------oo----------
---------------------------------%%%%----------------------------------##---------SS---------------------##--------------------%%%%------%%%%%%-------
------##-----------------------oo-||-----------------------------------##--------------------|-----------##---------------------||-----%-|||||--------
-----###---------------------%%%%%||-------------------|---------------##------------------%%%----------###---oo----------------|||-----||||||--------
-----###--------oooooo--------||||||-----------------oo|--------------####------------------|||%-----o-###-----------------------|------||||||--------
-----###---SS---%%%%%---------||||||---------------%%%%%-------------#####------------------||||---%%%%###---------%%%----------%%%%%---||||||--------
-----##----------|||----------||||||----------------|||-------------######------------------||||----||####----------|------------|||----||||||--------
-----##---------||||----------||||||----------------|||------------#######------------------||||----|||###----------||-----------|||----||||||--------
-----##---------||||----------||||-|----------------|||------------########---------ooo-o---||||----||||##--ooo-----|------------|||----||||||-----#--
XXXXXXXXXXXXX---||||---XXXXXX-||||----%%%-----%%%%%-||----%%XXXXXXXXXXXXXXX--------%%%%%%%--||||----||||----%%%%%%%%%%--XX----%%%%%%%---||||||----XXXX
XXXXXXXXXXXXX---||||---|XXXXX-||||-----||------|||--||-----XXXXXXXXXXXXXXXXX-%|-----||------||||----||||-----||-----||---XX----|||||----||||||----XXXX