------------------------------------------------------------------------------------------------------------------------------------------------------
------------------------------------------------------------------------------------------------------------------------------------------------------
------------------------------------------------------------------------------------------------------------------------------------------------------
------------------------------------------------------------------------------------------------------------------------------------------------------
------------------------------------------------------%%%%%----------------------------g--------------------------------------------------------------
--------o---------oo--------------------------oo--o-----||------ooooo---------oooo---%%%%%%---------------------------oo--oo---o--o-------------------
-----------SS----------------------#---------%%---------||-----%%%%%%--------%%%%%%---|||-------------#---------------------------------##------------
-----------------------------------#---------------%----|||------|||----------||||----|||-----------------------------------------------##------------
-------------------%%%%-----%%%---##-----SS-------------||||-----|||----------||||----||------------------------------------------------##------------
--------------------||------|%%--###--------------------||||------||------oooo||||----||-------------------------------------------#--####------------
---------------%%%--||------|||---##--------%------------|||-%%---||-%----%%%%%|||----||----------%%%%%--------------------------#########------------
----------------|---||------||-|-##----------------------|||-|----|||------|||||||----||------------||---------------------------########-------------
----------------||--||------||-|-#------------------------|-||----||||----||||||||----||-----|------||---------------------------#########------------
----------------||--||------||||%%%--------------------%%%|-||----||||----||||||||----||--oo%|%-----||---------------------------########-------------
XXXXXXXXX-%%%%%%||--||--%%%-||||||X-XXXXXXXXXXXXXXXXX---|-%-||--%%%%%|--%-||||||||--%-||----||----%%%%%----------XXXXXXXXXXXXXXXXXXXXXXXXXXX-X--------
XXXXXXXXX%-%%|--||--||---|--||--||XXXXXXXXXXXXXXXXXXX---||--||---|||||----||||||||----||----||-----|||-----------XXXXXXXXXXXXXXXXXXXXXXXXXXX----------