------------------------------------------------------------------------------------------------------------------------------------------------------------------------------------------------------------------------------
------------------------------------------------------------------------------------------------------------------------------------------------------------------------------------------------------------------------------
------------------------------------------------------------------------------------------------------------------------------------------------------------------------------------------------------------------------------
------------------------------------------------------------------------------------------------------------------------------------------------------------------------------------------------------------------------------
------------------------------------------------------------------------------------------------------------------------------------------------------------------------------------------------------------------------------
------------------------------------------------------------------------------------------y#----------------------------------------------------------------------------------------------------------------------------------
------------------------------------------------------------------------------------------##----------------------------------------------------------------------------------QQ------------------------QQQQ------------------
--------------------oooo-----------------------------------------------------------------###---------o--------oooooo--------------------------------------------------------------------------oo----oo----------------oo------
----------------------------------------------------------------------------------------####----------------------------------------------------------------------------------------------------------------------------------
--------------------------------------------------##--------------##-------------------#####------------------------------------------------------------------------------#---------------------------------------------------
-----------------TT------------------------------##---------------##------------------######----------------TT------------------------------------------------------------##--------------------TT------QQQ-------------------
-----------------TT-----------------------------####----------#-####-----------------#######----T-----------TT----------------------------------------------------------#-##------#-------------TT----------------------------
-----------------T----------TT----------------######----------######----------------########----TT----------TT----------------------------------------------------------#-##------------#--------T----------------------------
-----------------T----------TT-----------y--#-######--------########---------y-------#######----TT-----------T----------------------------------------------#----y-----#--##------------#--------T-----y----------------------
XXXXXXXXXXXXXXXXXXXXXXXXXXXXXXXXXXXXXXXXXXXXXXXXXXXXXXXXXXXXXXXXXXXXXXXXXXXXXXXXXXXXXXXXXXXXXXXXX---XXXXXX--XXXXXXXXXXXXXXXXXXXXXXXX--XXXXXXXXXXXXXXXXXXXXXXX--XXXXXXXXXXXXXXXXXXXXXXXXXXXXXXXXXXXXXXXXXXXXXXXXXXXXXXXXXXXXXXX
XXXXXXXXXXXXXXXXXXXXXXXXXXXXXXXXXXXXXXXXXXXXXXXXXXXXXXXXXXXXXXXXXXXXXXXXXXXXXXXXXXXXXXXXXXXXXXXXXX--XXXXXX--XXXXXXXXXXXXXXXXXXXXXXXX--XXXXXXXXXXXXXXXXXXXXXXXX-XXXXXXXXXXXXXXXXXXXXXXXXXXXXXXXXXXXXXXXXXXXXXXXXXXXXXXXXXXXXXXX