------------------------------------------------------------------------------------------------------------------------------------------------------------------------------------------------------------------------------
------------------------------------------------------------------------------------------------------------------------------------------------------------------------------------------------------------------------------
------------------------------------------------------------------------------------------------------------------------------------------------------------------------------------------------------------------------------
------------------------------------------------------------------------------------------------------------------------------------------------------------------------------------------------------------------------------
------------------------------------------------------------------------------------------------------------------------------------------------------------------------------------------------------------------------------
------------------------------------------------------------------------------------------------------------------------------------------------------------------------------------------------------------------------------
-------------------------------------------------------QQ---------------------------Q?SSQQ------------------------------------------------------------------------------------------------------------------------------------
----------------------------------------------------------------------------------------------------------------------------------------------------------------------------------------------------oo----------------oooo----
-----------------------------------------------------------------------------------------------------------------------------------------#------------------------------------------------------------------------------------
---------------------------------------------------------y-----------------------------y------------------------------------------------##------------------------------------------------------------------------------------
--------Q-----------------Q--------------------------QQ?SSQQ--------------QQ-----T--Q?SS-QQ-------------------------TT--------o--------###-------------------------------------------------------------------------TT---------
---------------------------------------------------------------------------------TT---------------------------------TT--#-------------####-------------------------------------------------------------------------TT---------
X-----TT-----------------------------------------T---------------------TT--------TT---------------------------------TT--#-------------####--------------------------------------TT---------------------------------TT---------
XX----TT-----------------------------------------T---------------------T---------TT--------y----------------------y-TT--#------------#####--------T------------y----------------TT-----y-----------------------y---TT---------
XXXXXXXXXXXXXXXXXXXXXX--XXXXXXXXXXXXXXXXXXXXXXXXXXXXXXXXXXXXXXXXXXXXXXXXXXXXXXXXXXXXXXXXXXXXXXXXXXXXXXXXXXXXXXXXXXXXXXXXXXXXXXXXXXXXXXXXXX-XXXXXXXXXXXXXXXXXXXXXXXXXXXXXX---XX--XXXXXXXXXXXXXXXXXXXXXXXXXXX--XXXXXXXXXXXXXX---
XXXXXXXXXXXXXXXXXXXXXX--XXXXXXXXXXXXXXXXXXXXXXXXXXXXXXXXXXXXXXXXXXXXXXXXXXXXXXXXXXXXXXXXXXXXXXXXXXXXXXXXXXXXXXXXXXXXXXXXXXXXXXXXXXXXXXXXXX-XXXXXXXXXXXXXXXXXXXXXXXXXXXXXX---XX--XXXXXXXXXXXXXXXXXXXXXXXXXXXXXXXXXXXXXXXXXXX---