------------------------------------------------------------------------------------------------------------------------------------------------------------------------------------------------------------------------------
------------------------------------------------------------------------------------------------------------------------------------------------------------------------------------------------------------------------------
------------------------------------------------------------------------------------------------------------------------------------------------------------------------------------------------------------------------------
------------------------------------------------------------------------------------------------------------------------------------------------------------------------------------------------------------------------------
------------------------------------------------------------------------------------------------------------------------------------------------------------------------------------------------------------------------------
---------------------------------------------------------------------------------------------------------------------------------------------y--------------------------------------------------------------------------------
---------------------------------------------------------------------------------------------------------Q--------------------------------------------------------------------------------------------------------------------
-------------o-----------oo-----------oo--------------------------------------------------------------------------------------------------------------------------------------------------------------------------------------
----------o-------------o--o--------------------------------------------------------------------------------------------------------------------------------------------------------------------------------------------------
------------------------------------------------------------------------------------------------------------------------------------------------------------------------------------------------------------------------------
----------------------TT----------------------------------------------------QQQ-------------------------Q---------ooT-------------------------QQQ---Q----------------------------------------------------------------ooo------
----------------------TT----------TT------------------------------------------------#-------------------------------T---------------------------------------------------------------------------------------------------------
-------TT-------------TT----------TT------------------------------------------------#-------------------------------TT--------------------------------------------------------------------------------------------------------
-------TT-------------TT----------TT---------------------------y--------#----y------#------------------------y------TT---------y-----y-------------y----#------y-----------------------y-----------------------------TT-------
XXXXXXXXXXXXXXXXX---XXXXXXXXX---XX--XXXXXXXXXXXXXXXXXXXXXXXXXXXXXXXXXXXXX--XXXXXXXXXX-XXXXXXXX--XXXXXXXXXXXXXXXXXXXXXXXXXXXXXXXXXXXXXXXXXXXXXXXXXXXXXXXXXXXXXXXXXXXXXXXXXXXXXXXXXXXXXXXXXXX----XXXXXX----------XXXXXXXXXXXXXXX
XXXXXXXXXXXXXXXXXX--XXXXXXXXX---XX--XXXXXXXXXXXXXXXXXXXXXXXXXXXXXXXXXXXXX--XXXXXXXXXXXXXXXXXXX--XXXXXXXXXXXXXXXXXXXXXXXXXXXXXXXXXXXXXXXXXXXXXXXXXXXXXXXXXXXXXXXXXXXXXXXXXXXXXXXXXXXXXXXXXXX----XXXXXX---oo-----XXXXXXXXXXXXXXX