------------------------------------------------------------------------------------------------------------------------------------------------------------------------------------------------------------------------------
------------------------------------------------------------------------------------------------------------------------------------------------------------------------------------------------------------------------------
------------------------------------------------------------------------------------------------------------------------------------------------------------------------------------------------------------------------------
------------------------------------------------------------------------------------------------------------------------------------------------------------------------------------------------------------------------------
------------------------------------------------------------------------------------------------------------------------------------------------------------------------------------------------------------------------------
---------------------------------------------------------------------------------------------------------------------------------------------------------------------------------------------------------------------o--------
-----------------------------------------------------QQQ-------------------------------------------------------------------Q-QQQQ------------------------------------------Q--------------------------------------------------
--------oooooo-----------------------o-------------------------------------------------------------------ooooooo------------------------oo------------------------------------------------------------------------------------
--------------------------------##--------------------------------------------------------------------------------------------------------------------------------------------------------------------------------------------
------------------------------####---------------------y---------------------------------------------------------------------yy-----------------------------------------------------------------------------------------------
-------------------------------###----------------?S?SSSQ------------------------o----------------------------------------Q?SSSQQQ-----------------------------------------------------------------------------T--T-----------
----------------------------######----------#-----------------------------------------------------------#---------------------------------------------------------------------------------------------------------T-----------
---------------------------#######----------#---------------------------------------------------------------------------------------#-----------------------------------------------------------------------------T-----------
---------------------------#######---y---y--#----------------------------------y-----y----------------------------------------------#------------------y-------------------y---------y--------------#----y--y-----T---y-------
XXXXXXXXXXXXXXXXX---XXXXXXXXXXXXXXXXXXXXXXXXXXXXXXXXXXXXXXXXXXXXXXXXXXXXXXXXXXXXXXXXXXXXXXXXXXXXXXXXXXXXXXXXXXXXXXXXXXXXXXXXXXXXXXXXXXXXXXXXXXXXXXXXXXXXXXXXXXXXXXXXXXXXXXXXXXXXXXXXXXXXXXXXXXXXXXXXX--XXXXXXXXXXXXXXXXXXXX---
XXXXXXXXXXXXXXXXX---XXXXXXXXXXXXXXXXXXXXXXXXXXXXXXXXXXXXXXXXXXXXXXXXXXXXXXXXXXXXXXXXXXXXXXXXXXXXXXXXXXXXXXXXXXXXXXXXXXXXXXXXXXXXXXXXXXXXXXXXXXXXXXXXXXXXXXXXXXXXXXXXXXXXXXXXXXXXXXXXXXXXXXXXXXXXXXXXX-XXXXXXXXXXXXXXXXXXXXX---