------------------------------------------------------------------------------------------------------------------------------------------------------------------------------------------------------------------------------
------------------------------------------------------------------------------------------------------------------------------------------------------------------------------------------------------------------------------
------------------------------------------------------------------------------------------------------------------------------------------------------------------------------------------------------------------------------
------------------------------------------------------------------------------------------------------------------------------------------------------------------------------------------------------------------------------
------------------------------------------------------------------------------------------------------------------------------------------------------------------------------------------------------------------------------
------------------------------------------------------------------------------------------------------------------------------------------------------------------------------------------------------------------------------
--------------------------------------------------------------Q-------------------------------------------------------------------------------------------------------------Q-------------------------------------------------
---------------------------------------------------------------------------------------ooo-----------------ooooo----------------------------------------------------------------------------------oooo------------------------
--------------------------------------------------------------------------------------------------Q-----------------------Q--------------------------------Q------------------------------------------------------------------
-------------------------------------------------------#-------------------------------------------------------------------------------------------------------------------y--------------------------------o-----------------
--------TT--------------------------------------Q-----#---QQQ?SSQQ----------Q?SSQQ--oTo--------------------------------------------------------Q-------------------------?SSQQ-------TT-------TT----------Q-#-----------------
--------TT---------------------------------------------#-----------------------------------------------------------------------------------------------------------------------------TT-------TT------------------------------
--------TT------------------------------------------#--#-----------------------------------------------------------------------------------------------------------------------------T--------TT------------#-----------------
--------TT---------------------T-----------------y-----#---y---------------y---y-----T----------------#---T--------------------------------------y-------------y-----------------y---T--------TT------------#----y------------
XXXXXXXXXXXXXXXX----XXXXXXXXXXXXXXXXXXXXXXXXXXXXXXXXXXX--XXXXXXXXXXXXXXXXXXXXXXXXXXXXXXXXXXXXXXXXXXXXXXXXXXXXXXXXXXXXXXXXXXXXXXXXX---X--XXXXXXXXXXXXXXXXXXXXXXXXXXXXXXXXXXXXXXXXXXXXXXXXXXXXXXXXXXXXXXXXXXXXX--XXXXXXXXXXXXX--
XXXXXXXXXXXXXXXX----XXXXXXXXXXXXXXXXXXXXXXXXXXXXXXXXXXX--XXXXXXXXXXXXXXXXXXXXXXXXXXXXXXXXXXXXXXXXXXXXXXXXXXXXXXXXXXXXXXXXXXXXXXXXX------XXXXXXXXXXXXXXXXXXXXXXXXXXXXXXXXXXXXXXXXXXXXXXXXXXXXXXXXXXXXXXXXXXXXX--XXXXXXXXXXXXXX-