------------------------------------------------------------------------------------------------------------------------------------------------------------------------------------------------------------------------------
------------------------------------------------------------------------------------------------------------------------------------------------------------------------------------------------------------------------------
------------------------------------------------------------------------------------------------------------------------------------------------------------------------------------------------------------------------------
------------------------------------------------------------------------------------------------------------------------------------------------------------------------------------------------------------------------------
------------------------------------------------------------------------------------------------------------------------------------------------------------------------------------------------------------------------------
--------------------------------------------------------------------------------------------------------------------------------------------------------------oo--------------------------------------------------------------
------------------------------------------------------------------------------------##----------------------------------------------------------------------------------------------------------------------------------------
---------------------------------------ooo----------------------------------------y###----------------------------------------------------------------------------------------------------------oo----------------------------
----------------------------------------------------------------------------------####-----------------#----------------------------------------------------------------------------------------------------------------------
----oo------------oo------------------------------------------------------------######-----------------#----------------------------------------------------------------------------------------------------------------------
----------------------------TT----------------------SSQQQ----------------------#######---------------#-#--------------QQQQ--------------------------------------------------------------------------QQ------------------------
----------------------------T---------TT--------------------------------------########--XX-------------#----------------------------------------------------------------------------------------------------------------------
----------------------------T---------TT-------------------------------------#########--XXX----------------------------------------------T------------------------------------------------------------------------------------
---------------------------------y----TT-------------y----------------------##########---------------------------------------------------T---------------------------------y-----------------------y--------------------------
XXXX--XXXXXXXXXXXXXXXXXXXXXXXXXXXXXXXXXXXXXXXXXXXXXXXXXXXXXXXXXXXXXXXXXXXXXXXXXXXXXXXXXXXXXXXXXXXXXXXXXXXXXXXXXXXXXXXXXXXXXXXXXXXXXXXXXXXXXXXXXXXXXXXXXXXX--XXXXXXXXXXXXXXXXXXXXXXXXXXXXXXXXXXX--XXXXXXXXXXXXXXXXXXXXXXXXXXXX-
XXXX--XXXXXXXXXXXXXXXXXXXXXXXXXXXXXXXXXXXXXXXXXXXXXXXXXXXXXXXXXXXXXXXXXXXXXXXXXXXXXXXXXXXXXXXXXXXXXXXXXXXXXXXXXXXXXXXXXXXXXXXXXXXXXXXXXXXXXXXXXXXXXXXXXXXX--XXXXXXXXXXXXXXXXXXXXXXXXXXXXXXXXXXX--XXXXXXXXXXXXXXXXXXXXXXXXXXXXX