------------------------------------------------------------------------------------------------------------------------------------------------------------------------------------------------------------------------------
------------------------------------------------------------------------------------------------------------------------------------------------------------------------------------------------------------------------------
------------------------------------------------------------------------------------------------------------------------------------------------------------------------------------------------------------------------------
------------------------------------------------------------------------------------------------------------------------------------------------------------------------------------------------------------------------------
------------------------------------------------------------------------------------------------------------------------------------------------------------------------------------------------------------------------------
------------------------------------------------------------------------------------------------------------------------------------------------------------------------------------------------------------------------------
---------------------------------------------------------------------------------------------------------------------------------------------------------------------------------------------------------------------Q--------
---------------------------------------------------------------------------------------------------------------------------------------------------------------oooooooo-------------------------------------------------------
-----------------------------------------------------------------------------------------------------------------------------------------------------------------------#------------------------------------------------------
------------------------------------------------------------------------------##-----------------------------------------------o--------------------------------------###-----------------------------------oo----------------
-------------QQQ------------------------Q------------------------------------#-#-------------------------------------------------------------------------------------####-----------------------Q--------------------QQQ------
------------------------------------TT-----------------------------------------#------------------------------------------------------------------------------------#####---------------oo--------------#---------------------
------------------------------------TT-----------------------------------------#------------T-------------------------------------TT--------------------TT---------######-------------------------------#---------------------
---------------y--------------------TT----------------------------------------##-------y----TT-------------y----------------------TT---y----------------TT--------#######--------y----------#---#-------#------------y---y----
XXXXX-------XXXXXX--XX----XXX-XXXXXXXXXXXXXXXXXXXXXXXXXXXXXXXXXXXXXXXXXXXXXXXXXXXXXXXXXXXXXXXXXXXXXXXXXXXXXXXXXX--XXXXXXXXXXXXXXXXXXXXXXXXXXXXXXXXX-XXXXXXXXXXXXXXXXXXXXXXXXXXXXXXXXXXXXXXXXXXXXXXXXXXXXXXXXXXXXXXXXXXXXXXXXXX
XXXXX-------XXXXXX--XX----XXX-XXXXXXXXXXXXXXXXXXXXXXXXXXXXXXXXXXXXXXXXXXXXXXXXXXXXXXXXXXXXXXXXXXXXXXXXXXXXXXXXXX--XXXXXXXXXXXXXXXXXXXXXXXXXXXXXXXXX-XXXXXXXXXXXXXXXXXXXXXXXXXXXXXXXXXXXXXXXXXXXXXXXXXXXXXXXXXXXXXXXXXXXXXXXXXX