------------------------------------------------------------------------------------------------------------------------------------------------------------------------------------------------------------------------------
------------------------------------------------------------------------------------------------------------------------------------------------------------------------------------------------------------------------------
------------------------------------------------------------------------------------------------------------------------------------------------------------------------------------------------------------------------------
------------------------------------------------------------------------------------------------------------------------------------------------------------------------------------------------------------------------------
------------------------------------------------------------------------------------------------------------------------------------------------------------------------------------------------------------------------------
------------------------------------------------------------------------------------------------------------------------------------------------------------------------------------------------------------------------------
----------------------------------Q---------------------------------------------------------------------------Q---------------------------------------------------------------------------------------------------------------
----------------------------------------------------------------------------------------------------------------------------------------------------oo----------------------------------------oooo----------------------------
-------------------------------------------------------------------------------------------------------------------------------------------------------------Q-Q-----------------------------------------------1--------------
------------------------------------------------------------------------------------------------------------------------------------------------------------------------------------------------------------------------------
---------------------QQ--Q--------Q------------QQQ----------------TT----------------Q---------------------------Q-------------------------------TT-QQQ--------------------------------------TT--------------------------------
------------------------------------------------------------------------------#-----------------------------------------------------------------TT------------------------------------------TT--------------------------------
--------------------------------------------------------------#---#-----------#-----------------------------------------------#-----------------TT------------------------TT----------------TT--------------------------------
--------------------yy---------------------------y------------#---#-----------#----y-------------y--------#-------------------#----------y------TT--y---------------------TT----------------TT-----------------y---y---y------
XXXXXXXXXXXXXXXXXXXXXXXXXXXXX---XXXXXXXXXXXXXXXXXXXXXXXXXXXXXXXXXXXXXXXXXXXXXXX--XXXXX--XX--XXXXXXXXXXXXXXXXXXXXXXXXXXXXXXXXXXX--XXXXXXXXXXXXXXXXXXXXXXXXXXXXXXXXXXXXXXXXXXXXXXXXXXXX-------TTXXXXXX--XXXXXX-XXXXXXXXXXXXXX---
XXXXXXXXXXXXXXXXXXXXXXXXXXXXX---XXXXXXXXXXXXXXXXXXXXXXXXXXXXXXXXXXXXXXXXXXXXXXX--XXXXX--XX--XXXXXXXXXXXXXXXXXXXXXXXXXXXXXXXXXXX-XXXXXXXXXXXXXXXXXXXXXXXXXXXXXXXXXXXXXXXXXXXXXXXXXXXX--------T-XXXXXX--XXXXXXXXXXXXXXXXXXXXX---