------------------------------------------------------------------------------------------------------------------------------------------------------------------------------------------------------------------------------
------------------------------------------------------------------------------------------------------------------------------------------------------------------------------------------------------------------------------
------------------------------------------------------------------------------------------------------------------------------------------------------------------------------------------------------------------------------
-----------------------------------------------------------------------------------------------#--------------------------------------------------------oo--------------------------------------------------------------------
----------------------------------------------------------------------------------------------##------------------------------------------------------------------------------------------------------------------------------
--------------------------------------------------------------------------------------------####------------------------------------------------------------------------------------------------------------------------------
------------Q------------------------------------------------------------------------------#####------------------------------------------------------Q-----------------------QQ----------------------------------------------
------------------------------------------------------------------------------------------######----------------------------------------------------------------------------oo------------------------------------------------
----------------------------------QQQ----#------------------------------------------------######------------------------------------------------------------------##----------------------------------------------------------
-----------y-----------------------------#----------------------------o-----------------###-#----------------------------y-----------------------------------------#----------------------------------------------------------
--------Q---QQ---------------------------#----------------------------T-----------------##---------------------------Q??SSQQQQQ-----------------Q----Q----------#--#------T-QQSQQQ--------------------------------------------
-----------------------------------------#---------------------------------------------#-#----------------------------------------------------------------------####-----TT---------------------------------------------------
--------------------------------------------------------------------TT-----------------#-----------------------------------------------------------------------#####-----TT---------------------------------------------------
---------------------------------------------y----------------------TT-------y-----y--#--#-----------------------------------y----------------T---------------###-##-----TT--------------------y-----y---------------------y--
XXXXXXXXXXXXXXXXXXXXXXXXXXXXXXXXXXXXXXXXXXXXXXXXXXXXXXXXXXXX--XXXXXXXXXXXXXXXXXXXXXXXXXXXXXXXXXXXXXX--XXXX--XXXXXXXXXXXXXXXXXXXXXXXXXXXXXXXXXXXXXXXXXXXXXXXXXXXXXXXXXXXXXXXXXXXXXXXXXXXXXXXXXXXXXXXXXXXXXXXXXXXXXX--XXXXXXXXXX
XXXXXXXXXXXXXXXXXXXXXXXXXXXXXXXXXXXXXXXXXXXXXXXXXXXXXXXXXXXX--XXXXXXXXXXXXXXXXXXXXXXXXXXXXXXXXXXXXXX--XXXX--XXXXXXXXXXXXXXXXXXXXXXXXXXXXXXXXXXXXXXXXXXXXXXXXXXXXXXXXXXXXXXXXXXXXXXXXXXXXXXXXXXXXXXXXXXXXXXXXXXXXXX--XXXXXXXXXX