---------------------------------------------------------------------------------------------------------------------------------------------------------------------
---------------------------------------------------------------------------------------------------------------------------------------------------------------------
---------------------------------------------------------------------------------------------------------------------------------------------------------------------
---------------------------------oo----------------------------------------------------------------------------------------------------------------------------------
---------------------------------------------------------------------------------------------------------------------------------------------------------------------
-------------------------------------oooo---------Sooo-------------------------------------------------------------oo------------------------------------------------
---------------------------------SS-S--------SSS--------------------SS--------------------------------------------------%%%%%Soo-------%%%%-----SSS--------SS--------
------------ooooooo---------------SS---------------------------------------------------------------------Soooo------------||------------||---------------------------
----------SSS----------S---------------SSS----------SSS----------o--------SSSSoo-----%-----------------------------S------|-------------||---------------oo----------
----------------------------------------------------------------SS------------------|-------------------------------------|-------------||---------------SS----------
-------------%%%%-------------%-----------------------%%%%%-------%%%-%%%----------||-%%%%%%%%%------------SSS-----------SSS---SSSS------|-%%%%--------------%%%%----
--------------||---------------|-----------------------|||---------||--||----------||-|||--|||-------------------------------------------|--||----------------||---X-
--------------||---------------%%%%%%%-----------------|||---------||--||----------||-|||--|||-------------------------------------------|-|||----------------||---X-
--------------||---------------||-||-------------------|||---------||--||----------||-|||--|||-------------------------------------------|-||----------------|||--XXX
XXXXX--%%%%%%%||------%%%%--%%%||-||------%%%---%%%%---|||%%%%%----%%%-||----------|||||%%%|||----%%%%%%%-------%%%%-------XXXXXXXXX--%%%%%%|%%%%%%-%%%%-----||||XXXX
XXXXXX--|||---||-------||----|-||-||------||-----||----|||-|||-----||--||----------||||-||-|||-----|||||---------||---------X-XXXXX----|||-||-||||---||------||||XX|X