---------------------------------------------------------------------------------------------------------------------------------------------------------------------
---------------------------------------------------------------------------------------------------------------------------------------------------------------------
---------------------------------------------------------------------------------------------------------------------------------------------------------------------
---------------------------------------------------------------------------------------------------------------------------------------------------------------------
---------------------------------------------------------------------------------------------------------------------------------------------------------------------
------------------------------------------------------------------------------------------------------------------------ooo------------------------------------------
--------------------------------------SS---%%%%-----------SSS-------------------------------------SSS-----------------%%%------------o---------------S---------------
----------Soo-------------------------------||-------------------------------------------------------------------------||--------------------------------------------
----SSS-------------------------------------||-----------------------S-------------SS--o-----SSS-------Soooooo--SS-----|---------SSS--------%----------oo------------
--------------------------------------------||--------------------------------------------------------------oo---------|-------------------|-------------------------
------------SSS%%%%-------%%%---%%%%--------||----SS----%%%%%---%%%%----SSS--%%%%----------%------%%%------------------|-%%----------------|--------S--SS--%%%%------
----------------||---------|%%%--||---------||-----------|||-----||-----------|||%-----%%%||-------||--S---------|-----|-|----------SSS----|-----SSS--------||-------
----------------||---------|||--|||---------||-----------|||-----||------------|||-------|||-------||------S-----|-----|-|--------------%%%%%---------------||-------
----------------||---------|||---||---------||-----------|||-----||------------|||-------|||-------||------SS----|-----|-|---------------||||---------------||-----X-
XXXXX%%%--------||-%%%----||||---||-------%%%%XXXXXXX%%%%|||-%%%%||%%--%%-%%%%-|||--%%%%%|||----%%%|%%--------%%%%%----%%%-%%%%%%%%%-----||||---------------||-XXXXXX
XXXX-||---------||--|------|||---||--------||XXXXXXX--||-|||--||-||--------||--|||---|||-|||-----|-||----------|||------||--||||-||------||||---------------||-XXXXXX