---------------------------------------------------------------------------------------------------------------------------------------------------------------------
---------------------------------------------------------------------------------------------------------------------------------------------------------------------
---------------------------------------------------------------------------------------------------------------------------------------------------------------------
---------------------------------------------------------------------------------------------------------------------------------------oo----------------------------
----------------------------------------------------------------------------%%%%%------------------------------------------------------------------------------------
---------------------------------------------------------o--------------------||-------------------------------------------------------------------------------------
------------SS-------%%%%-----SSSSS----------------------------SSSSS----------||-----------S------------------SSS-oo-----S-------SS--SSS------%%%%-------------------
----------------------||------------------------%ooo---------------------------|-----------------------------------%---------------------------||--------------------
----------------------||---------|---------------------------------------------|----------------SS----------------------------------------SS---||--------------------
----------------------||---------|----------------------oooo-----------------S-|---|-------------S-----------------------------oooo------------||--------------------
----------------------%%%%%%%----------------------SSSSS----------------%%%%---|--SS----%%%%%%-------SS---%%%%%----S------%%%%%%---------------||%%%-----------SS----
------------%%%--------||-||---------------------------------------------||--------------||||--------------|||-----SSSS-----|||----------------||||------------------
------------||---------||-||-------|----%%%%%-------------------------%%%%%%-------------|-||--------------|||--------------||||---------------||||------------------
------------||---------||-||-------||----|||---------------------------||||--------------|-||--------------|||--------------||||---------------||||----------------X-
XXXXXX%%%%%-||%%%%-----||-||-%%%%--||----|||-------------------%%%---%-||||-%%%%-----%%%%%%||%-%-------%%%-|||-------------|||||---------%%----||||%%%XXXXXXXXXXXXXXX
XXXXX--|||--||-|-------||-||--||---||----|||--------------------|------||||--||-------||-|-||----------||--|||--------------||||---------|-----||||-||XXXXXXXXXXXXXXX