---------------------------------------------------------------------------------------------------------------------------------------------------------------------
---------------------------------------------------------------------------------------------------------------------------------------------------------------------
---------------------------------------------------------------------------------------------------------------------------------------------------------------------
-----------------------------------------o---------------------------------------------------------------------------------------------------------------------------
--------------------------------------------------------------------------------------------------------------------------------------------------------oo-----------
----------oooooo-----------------------------------------------------------------------------------------------------------------------------------------------------
----------------------SSS----S----------SSSS------SS-------------------------SSS------------------%%%%%----------|----------------------%%%%---------SSS-------------
-----------------------------------------------------------------------------------------ooo-------|||-----------|-----------------------||--------------------------
------------SS--S------------------------------------------------------------------SSS---------o---|||---------S-|--SS----%%%%-----------||--------------------------
----------SSS--------------SSS---------------------------------------------SSS-----------------SS--|||---------SSSSSS------||------------||--------------SSS---------
----------------------------------%%%%%-----SSSS------%%%%-------------S--------%%%%-----SSSS------|||%%%%-----------------||----------S-||--%%%%%%%%----------S-----
-----------------------------------|||-----------------||------%%%%%%------------||---------------%%||-||------------------||----------S-|---|||||||-----------------
-----------------------------------|||-----------------||%%-----||||-------------||-----%%---------|||-||------------------||----------------|||-|||-----------------
-----------------------------------|||-----------------|||-----|||||-------------||------|---------||||||------------------||----------------||--|||-----------------
XXXX%%%%---------XXX%%%%%---%%%%%%%|||------%%%-%%%%---|||-%%%%|||||-%%%%-%%%----||-|%---|%%%------||||||------------------||-%%%%%%---------|||-|||-----------%%----
XXXXX||----------XXX-|||----||--||-|||-------|---||----|||--||-||||---||--||-----||-|----|||-------|-||||------------------||--|-||----------||--|||-----------|-----