---------------------------------------------------------------------------------------------------------------------------------------------------------------------
---------------------------------------------------------------------------------------------------------------------------------------------------------------------
---------------------------------------------------------------------------------------------------------------------------------------------------------------------
---------------------------------------------------------------------------------------oooo--------------------------------------------------------------------------
---oo-------------------------------------------------------------------------------------%----------------------------------------------------------o---------------
---SS-----------------------------------------ooo--------------------------------------------ooo---------------------------------------------------------------------
-------------------------------SSS--------SSS%--------SS---------------------------------SSS------o-------SS------------SS-------S-----%%SS--------SSS----SS---------
-----------------------------------------------------------------o-------------------------------o-------------------------------------------------------S-----------
--SSSS-----------------------------------------S-----------SSS-----------------S--------------SSS----%%%-------------------------------S-----------------------------
--SSS------------------------------------o----------------------------------SSSS-----------S----------||-------------------------------------------------------------
-------------%%%%-------------------%%%%------S-%%%---%%%---------SS%%%%%----------S%%%%------------%|||------%%%%--------------%%%%-------%%-%%%%%%----------SS-----
------------||||---%%----------------||-------S--||----|-------------|||-------------|||--------SSS--|||-------||%---------------||---------||-||||------------------
------------||||---||----------------||----------||----|-------------|||-------------|||-------------|||-------||----------------|%%%-------|||||||------------------
------------||||---------------------||----------|---|-|-------------|||-------------|||-------------|||-------||----------------|||--------|||||||----------------X-
XXXX-----%%%||||%%%%%%%%-------------||-%%%------|---|-|---%%%%%%----|||%%%----------|||-------------|||%%%%%%%||-||%-%%%----%%%-|||--%%%---|||||||-------------XXXXX
XXXX------|-||||-||||-||-------------||-||-------|---|||------||-----|||-|-----------|||-------------|||-||--|-||-||---|-----||--|||---||---|||||||--------------XXXX