---------------------------------------------------------------------------------------------------------------------------------------------------------------------
---------------------------------------------------------------------------------------------------------------------------------------------------------------------
---------------------------------------------------------------------------------------------------------------------------------------S-----------------------------
-----------------------------------------o-------------------------------------------------------------ooo-----------------------------------------------------------
-------------------------------------------------------------------------------------------------oo------------------------------------------------------------------
--------------------------------------------------------------oo-----------------------------------------------------------------------------------------------------
----------SSSS---------------------------SSS------%%%-------------------------------SS-----SSS----------SS-------------------------------SSS-------------------------
---------------------------------------------------||--------------------------oo------------------------------------------------------------------------------------
-----SS---------------%----------------------------||----------S-S------------------------------SS-----------------------------SSSSS---------------------------------
---------------------------------------------------||----------SS----------------------------------------%%----ooo------------------------SS-------------------------
------------------%%%%----------------%%%------SS--||-%%%%-----------S--%%%---%%%SS-SS---------S-------%-|------------%%%S----------------------%%%%---%%%%----------
-------------------||------------------|-----------||-|||----------------|-----|-------------------------||--------------------------------------||------|-----------
-------------------||---%%%%-----------|-----------||-|||----------------|-----|-------------------------||------------------------%%%%%%--------||------|-----------
-------------------||----||------------|-----------||-|||----------------|-----|-------------------------||-------------------------||||---------||------|---------XX
XXXXXX%%%%---------||---%||%%%---%%%---|-----------|||||%%%%----%%%%%%%%%|--%%%%%%%%--%%%%%%------------|||------XXXXXXXXXXXXXXXX---||||--------||%%%%%-||-XXXXXXXXXX
XXXXX-%||----------||----||||-----|----|-----------||-|||||------|||--|--|---|-||||----||||-------------|||-------XXXXXXXXXXXXXXXX--||||--------|||-||--||-XXXXXXXXXX