---------------------------------------------------------------------------------------------------------------------------------------------------------------------
---------------------------------------------------------------------------------------------------------------------------------------------------------------------
---------------------------------------------------------------------------------------------------------------------------------------------------------------------
---------------------------------------------------------------------------------------------------------------------------------------------------------------------
---------------------------------------------------------------------------------------------------------------------------------------------------------------------
-------------------------------------------------------------|-------------------|-----------------------------------------------------------------------------------
---------SSSSS--------Sooo-SSS-------------------------------|-----------S----%%%|---------------------------SSSSS----------------%%%%---SSS-------------------------
-------------------------------------------------------------|-----------------|||-------------------------------------------------||--------------------------------
---------------------------------------------%%%%------S-----|-----------------|||-----------------------S-------|-----------------||--------S----------SSS----------
----------------------------------------------||-------------|---------------|-||--------------------------------|-----------------||--------------------------------
---------------SSSS---------%%%%%%%-------SS--||------------%%%%%%-----------S-||---S---%%%--------------------%%%%----SSS------S--||---------%%%%%%--------%%%%-----
------------------------------||||-----------|||-------------||||------------|-|---------||%%%%%%%%------SSS-----|-----------------||----------||||----------||------
-----------------------------|||||-----------|||-------------||||--------------|---------||-||-||||--------------|-----------------||----------||||----------||------
-----------------------------|||||-----------|||-------------||||--------------|---------||-||-||||--------------|-----------------||----------||||----------||----X-
XXXXXXXXXXX----------%------%%%|||%%%%%%-----|||-------------||||%%%%%%%-----%%%%%----%--||-|%-||||%%%%----------|--XXXXXXXXX%---%%||--X---%---||||-%%----%%%||-XXXXX
XXXXXXXXXXX------------------||||--||||------|||-------------||||-|||||-------|||------|-||-|--||||-||-----------|-XXXXXXXXXX------|||-XXX-%%--||||-|------|-||-XXXXX