---------------------------------------------------------------------------------------------------------------------------------------------------------------------
---------------------------------------------------------------------------------------------------------------------------------------------------------------------
---------------------------------------------------------------------------------------------------------------------------------------------------------------------
-----------------------o----oo---------------------------------------------------------------------------------------------------------------------------------------
----------------------------------------------------------------SS-----|---------------------------------------------------------------------------------------------
-----------------------------------------------------------------------ooo-------------------------------------------------------------------------------------------
----------------------SSSS--SS------------------------SSSS---------------------------------------------------S-----------------o---%%%%-----------------SSS--SS------
------------------------------------------------------------------------------------------------------------------------------------||------------ooo----------------
----------SS----------------------------------oo-------------------------SS----------------------------------------------------------|-------------------------------
---------------------------------------------SS--------------------SSSSSSS-----------------------------------------------------------|-------------------------------
----------------%%-------------%%%-----SS-------%%%%%S-----%%--------------------SS---%%%%%------------%%%%--------------%%%%%---SS-%%%%%%%%%---SSS------------------
-----------------|%%%%%---------||---------------|||-------||--------------------------|||-------------|||----------------|||--------||---||-------------------------
-----------------||||||---------||-------|-------|||-------||--------------------------|||-------------|||----------------|||--------||----|-------------------------
-----------------||||||---------||-------|-------|||-------||--|-----------------------|||-------------|||----------------|||--------||----|-----------------------X-
XX------------%%%%||||----%%%%--||---%%%%|-------|||-------||-%%%%%%%-----%%----%%-----|||-XXXXXX--%%%%|||-------------%%%%|---------||%%%%%%%%%%-%%%--%%%---|--XXXXX
XX----------------||||-----||---||----||-|-------|||-------||-||||||-------------------|||-XXXXXX---||-|||---------------|||---------||--||||||----|----|----|--XXXXX