---------------------------------------------------------------------------------------------------------------------------------------------------------------------
---------------------------------------------------------------------------------------------------------------------------------------------------------------------
---------------------------------------------------------------------------------------------------------------------------------------------------------------------
------------------------------oo-------------------------------------------------------------------------------------------------------------------------------------
---------------------------o----------------------------------------------------------------------------%%%--------------------------------o-------------------------
---------------------------------------------------------------------------------------------------------||----------------------------ooooo----------------oo-------
----------------SS------------SSSooo--------------------SSoo--------------SSS-------%%%-------SS-------S-||%%%%----------------SS-SS----------SSS--------------------
-------------------------------------------------------------------------------------|-------------------||-||-------------------------------------------------------
----------%%%------------SS-S---------------------%%%--------------------------------|--%%%--------------||-||-------------------------SSSS-------%%%------SSSSS-----
----------||-----------------------%%%%%-----------|---------------------------------|---|---------------||-||-------------------------------------||----------------
-------S--||--SSS--------------SS--||||----------%%|--------%%%---%%%%-----------S---|---|-------S-------|-|||-----%%%-----------------------------||----------------
----------||-----------------------||||-----------||---------||%---||----------------|---|----------------%|||-%%%%%%------------------------------||----------------
----------||-----------------------||||-|---------||---------||----||---%%%--------------|-----------------||||-|||||------------------------------||----------------
----------||-----------------------||||-||--------||---------||----||----|---------------|-----------------||||-|||||------------------------------||--------------X-
X--------%%%%-%%%%%%%%%%%%%%-------||%%%||--------||-%%%%%%-%||-%%%|||-%%%%%-------------|--%%%%%----------||||-|||||---%%%%%%--------%%%%---------||||XXXXXXXXXXXXXX
X---------||----|||---||||---------||-|-||--------||--||||---||-||-||----||--------------|---|||-----------||||--|||-----||||----------|||---------||||XXXXXXXXXXXXXX