---------------------------------------------------------------------------------------------------------------------------------------------------------------------
---------------------------------------------------------------------------------------------------------------------------------------------------------------------
---------------------------------------------------------------------------------------------------------------------------------------------------------------------
---------------------------------------------------------------------------------------------------------------------------------------------------------------------
---------------------------------------------------------o-----------------------------------------------------------------------------------------------------------
--------------------------ooooooo------------------------------------------------------------------------------------------o-------------------------oo--------------
-----SSSoo-----SSS------SS--------%%%----------------SSS--%%%---------%%%---SSS----------SS---------%%%-------SS---SSSSo----------------------|----------------------
-----------------------------------|-----------------------|-----o-----|-----------------------------oo---------------------------------------|----------------------
-----------------------S----SSSS---|-----------------------|-----------|----------%%%%%-----SS-----------------|----------SS-%%%%----S--------||-----SSSS------------
-----------------------------------|---------------------|-|-----------|-----------|||-------------------------|-------------%||--------------|----------------------
-----------SSS--%%%----------------|%%%%%%%--------------|-|%%%%-SS----|%%%----S---|||------------------------%%%%%%S-SS-----|||------S------||--%%%-----------------
-----------------|-----------------|-|||||---------------|||-||--------|||---------|||-------------------------||||----------|||-------------||%%||------------------
-----------------|-----------------|-|||||---------------||||||--------|||---------|||-------------------------||||----------|||-------------||-|||------------------
-----------------|-----------------|||||||---------------|||||---------|||---------|||-------------------------||||----------|||-------------||||||------------------
XXXXXX--%%%------|-%%%%%-----------|||||||------------%%%|||||---------|||---------|||-%%%%%%%%-------%%%--------||----------|||--------------|||||---%%%-----X-XXXX-
XXXXXX---|-------|--|||------------|||||||---------------|||||---------|||---------|||---||%||---------|---------||----------|||---------------||||----|---------XXXX