------------------------------------------------------------------------------------------------------------------------------------------------------
------------------------------------------------------------------------------------------------------------------------------------------------------
------------------------------------------------------------------------------------------------------------------------------------------------------
------------------------------------------------------------------------------------------------------------------------------------------------------
-----------------------------------------------------------------------------------g------------------------------------------------------------------
--------------------------oo----------------------------------oo------%%%%%%%%-%%%%%%-------------------oo--------------------------------------------
------------SSSS-----------------------##--------------------%%%%------||||||---||||---%#%-------------------------------------SSSS-------------------
------o--------------------------------##---------------------||----o---|||||---||||----|#----------------------------------------SS------------------
-------------------------------------###----------------------||---%%%--|||||---||||-|##||-----%---g---------------S----------------------------------
-------------------------------------###----------------------||----||--||||||--|||||||#||------%%%%%------%%%%----SSS--------------------------------
------------------S-----------%------###----------------SSSSSSS|----||--|||||---||||||||||------||||--------|%----------------------------------SS----
------------------------------%%%%%---##----------------------||----||--||||||--||||||||||------||||--------||----------------------------------------
------------------------------||||--------SS------------------||--%%%---||||||--||||||||||------||-|-%%%%---||----------------------------------------
-----------o%%----------------||||----------------------------||--||----||||-|---|-|||||-|------||-|--||----||----------------oo----------------------
------%%%%%XXXXXXXXXXX--------||||-XXXX---------%%%%%------%%%-|--||----||||-|-%%%--||||--------||-|--||----||-------XXXXXXXXXXXXXXXXXXXXXXXXX--------
-X-----||--XXXXXXXXXXX--------||||--XXX----------%||--------|--|--||----||||----||--||||--------||-|--||----||--------XXXXXXXXXXXXXXXXXXXXXXX---------