------------------------------------------------------------------------------------------------------------------------------------------------------
------------------------------------------------------------------------------------------------------------------------------------------------------
------------------------------------------------------------------------------------------------------------------------------------------------------
------------------------------------------------------------------------------------------------------------------------------------------------------
---------------------------------------------------------------------------------g--------------------------------------------------------------------
----------------------------oo--------oo---o-----------------------------------o-%--------------ooooooo-%%%%%%-----%%%%ooo---o%%%---------------------
---------------#-----------------------%%%%%%%%---------------------------------%S-SSS---------%%%%%%%---||-|------||%%%%%----||----------------------
---------------##-----------------------||||||----------------------oo----------||------oo------||||||----|||----%||||||||----------------------------
---------SS-#############--------%%%%---||||||----------------------------------||--------------||||||---|||%---||||||||||----------------------------
------------#############---------||----||||||----------%%%%%%%------------------|--------------||||||---||||---||||||||||-------------------------#--
----------###############---------|||---|||||------------|||||---------------SSS%%%-------%-----||||||----|||---||||||||||---%%%%---%%%%%%-%%%%--###--
----------###############---------||-|--|||||------------|||||-------------------|--------%%----||||-|----||----||||||||||----||----|||||---||---###--
----------##############--------%-||-|--||||-------------|||||-------------------|--------||----||||----%-||----||||||||||----|%----|||||---||---###--
----------#############----------|||-|--||||-------------|||||------------------------oo--||----||||----%|||----||||||||||----||--%-|||||---||---###XX
-XXXXXXXXXXXXXXXXXXXXXXXXXX|----||||-|--||||-|-XXXXX%%---|||||-------%%%----%%%%%%%%%%%%%-||----||||----||||----||||||||||----||--||||||----||-|XXXXXX
--XXXXXXXXXXXXXXXXXXXXXXXX|-----||||----||||----XXXX|----|||||--------|------||---||--||--|-----||||----||||----||||||||||----||--||||||----||-|-XXXXX