------------------------------------------------------------------------------------------------------------------------------------------------------
------------------------------------------------------------------------------------------------------------------------------------------------------
------------------------------------------------------------------------------------------------------------------------------------------------------
------------------------------------------------------------------------------------------------------------------------------------------------------
---------------g---------------------------------------------------------------g----------------------------------------------------------------------
------oo---%%%%%--------------------------------oo-----%%%%%%----%%%%%%%%--%%%%%--------------oo------------------------------------------------------
------%%%------------------------%%---------------------||||---%%|||||||----||-------------%%%%%%---%%%-#SSSSS---SSSSSS-----------------%%%%%-#SS-----
-------|---------------oo--------|----------------------||||----||||||||----||------oo------||||----||----------------------------------||||----------
-------||----------------------%%%%%--------------------||||----||||||||----||--------------||||----||--#-------------------------------||||----------
-------|||%%%-------------------|||----%%%%%%-----------||||----||||||------||--------------||||----||-###------------------------------||||-##-------
-------|||||-------------#------||||----||||-%%%%%%%%---||||----||||||------||-----%%%%%----||||-----|###------------------%%%%----%%%%-||||-##-------
-------|||||-------------#------||||----||||--||||||----||||----||||-|------||------|||-----|||-----------------------------||------||--||||----------
-------|||||-------------#------||||----||||||||||||----||||----||||-|------||------|||-----||------------------------------||------||--||||#---------
-------|||||-------------#------||||----||||||||||||----||||----||||--------||------|||-----||------------------------------||------||--||-|----------
X%-----|||||--%%%%XXXXXX--|-----||||----||||||||||||----||||----||||XXXXXXX-||------||||--%-||%-%XXXXXXXXXXXXXXXXX-XX%---%%-||----%-||--||-|-%-----%--
|------|||||---|%%%%XXXXXXX-----||||----||||||||||||----||||----||||-XXXXXXX||------||||----||-%%%XXXXXXXXXXXXXXX-XX|-------||------||--||--|---------