------------------------------------------------------------------------------------------------------------------------------------------------------
------------------------------------------------------------------------------------------------------------------------------------------------------
------------------------------------------------------------------------------------------------------------------------------------------------------
------------------------------------------------------------------------------------------------------------------------------------------------------
-------------g----------------------------------------------------------------------------------------------------------------------------------------
---------%%%%----ooo------------------------------------------------------oo-----------------------------------------ooo------------------------------
-----------|-------------------------------------------SSSS-------------------------------------S-------------------------------------------SSSSS%----
----------||----------------------------------oo------------------------------------------------------oo--------oo--------------oo--------------#-----
-------SS--|-------------------------------####------------------------------------------%%%---------------------------------------------------##-----
----------||-------------------------------####------------------------------------------||-%-----------------------oo----------------o--------###----
----------|------------------------------######-------%%%%%--------------%%%%--------%%%%|||-----------------SS----%%%%%-%---------------------###----
-----------|-----------------------------######---------||----------------||----------||||||------------------S-----||---------#--------------####----
---------SSSS---------------------------#######---------||----------------||----------||||||------------------------||--|------#-------------####-----
-----------------------------%%%---------######---------||---------------|||----------||||||--------------------o---||---------#-------------####--#--
XXXX-------------------------||-----%XXXXXXXXXXXX-------||--XXXXXXXXXX----||--------%-||||||-XXXXXXXXXXX--------%%%-||-----XXXXXXXXXXXXXXXXXXXXXXXXXXX
XXX--------------------------||-------XXXXXXXXXXX-------||--XXXXXXXXXX----||----------||||||--XXXXXXXXXXX--------|--||------XXXXXXXXXXXXXXXXXXXXXXXXXX