------------------------------------------------------------------------------------------------------------------------------------------------------
------------------------------------------------------------------------------------------------------------------------------------------------------
------------------------------------------------------------------------------------------------------------------------------------------------------
------------------------------------------------------------------------------------------------------------------------------------------------------
-----------------------------------------------------------------------------------------------------g------------------------------------------------
--------------------o-----------------oo----%%%-------------ooo-o------o-ooXo---o--------------%%%%%%%%---oooo-----------------oooo-------------------
---------------------------------------%%%%%%|-------------%%%%%%-------%%%%%-------------------||||||-----%%%%--------------%%%%%%%------------------
------------or--------oo----------------||||||--------------||||-----o----||--------------------||||||------||----------------|||||-------------------
-----%%%%%%%%%----------------%%%%%-----|||||----####-------||||---------|||--------------------||||||------||-----------------||||---------SS--------
------|||||||------------------|||--%%--||||-----#####------||||----------||-----------SoS------||||||------||----------------|||||-------------oo----
------|||||||------------------|||--||--||||-----#####----|-||||---SSSSSS-||--------------------||||||----%-||-------------%%%%%%||-------------------
------||||||||-----------------|||--||--||||----#####-----||||||----------||--------------------||||||----|-||-----o--------||||-||-------------------
------||||||||---------------%-|||--||--||||-----####-----||||||----------||-------------%%%%---||||||----|-||--------------||||--|-------------------
------||||||||--------oo------||||--||--||||-----##-%%%%%-||||||----------||--------------||----||||||----|-||--------------||||--|-------------------
------||||||||-------%%%%%----||||--||--||||-XXXXXX-||||--||||||---------%%%%---%%--------||----||||||---%%%||------%%%%%%%-||||--%%%-XXXXXXXXX%------
------||||||||--------%||-----||||--||--||||-XXXXXXX||||--||||||----------||----|---------||----||||||----||||-------|%|||--||||--||--|-XXXXX-X---X---