------------------------------------------------------------------------------------------------------------------------------------------------------
------------------------------------------------------------------------------------------------------------------------------------------------------
------------------------------------------------------------------------------------------------------------------------------------------------------
------------------------------------------------------------------------------------------------------------------------------------------------------
-------------------------------------------------------------#----------------------------------------------------------------------------------------
--------------------------o--------------ooo-----------------##-----------------------------------------------oo--------------------------------------
-----------------------------------------%%%%%%%%%-------SSS###---######-----------------%%%%----------------------%%%%-------------------------------
------------------------------------------||||||-------------###########------------------||------------------------|-------------oo------------------
-------------------------%%%%-------------||||||-------------###########---------------%%%||------------------------||-----------------%%%%-----------
-----------|------o-------||--------------||||||-------------###########----------------||||-------%%%%--------------|------------------||------------
--------S------------%%%%-||------%%%-----||||||--|----------##########-----------------||||--------|---------%--%%%%%%----SSS---%%%--||||---%%%%%----
-----------------------|--||------||------||||||--#----------##########------------%%%%-||||----------------------|-||------------|---||||----||------
----------------------||--||------||------|||||---------------#########-------------||--||||----------------------|-||------------|---||||----||------
-----------%%%--------||--||------||-------|||-----------------########-----------%|||--||||--%%------------------|-||--oo------oo|---||||-%%-||------
XXXXXXXXXXXX|%------%-||--||%---%-||---XXXXXXXXXXXXX--%%%-XXXXXXXXXXXXXXXXXXXXX---||||--||||-------------%%%%%%%%%%%||-%%%%%%--%%%%%--||||-|--||------
XXXXXXXXXXXX||--------||--||------||---XXXXXXXXXXXX----|--XXXXXXXXXXXXXXXXXXXX----||||--||||--|-----------||--||--||||--%%%-----|||---||||----||------