------------------------------------------------------------------------------------------------------------------------------------------------------
------------------------------------------------------------------------------------------------------------------------------------------------------
------------------------------------------------------------------------------------------------------------------------------------------------------
------------------------------------------------------------------------------------------------------------------------------------------------------
------------------------------------------------------------------------------------------------------------------------------------------------------
----------------------------oo-------------------------------------------------------------------------------------------o----------------------------
-----%%SSSSSSSS----##--------------------%%%%%%%%----------------------------------------------------------------------------------####---------------
------|-------------#---SSSS--------------||||||-----------------------------%%%%----------SSS--oo------------oo-------oS----o-----##-----------------
------------------#----------------------%||||||-----------%%%%%%%%-----------||-------------------------------------------------#####%%%%%%----------
-----------------###---------------------|||||||------------||--||----------|-||-------------------------------------------------##---||--||----------
------------SS---###---------------------|||||||------------||--||---------||-||----------------------SSSSS------S--------------###---||--------------
-----------------------------------------|||||||----------------||---o-----|--||-------------------S-----------------------------##---||--------------
------------------------------------S----|||||||----------------||---------||-||--------------------------------------------------#----|-|------------
----------------------------------------||||||||----------or----||---------|||||----------------------------------------oo-----#--#----%%%%--------#--
--X%------------------%%%-XXXXXX--------||||||||----XXXXXXXXXXXXXXXXXXXXXXXXXXXXXXXXXXXXXXXXXXXX------------%%%%%%---%%%%%XXXXXXXXXXX--|||------XXXXXX
--|--------------------|--XXXXX---------|||||||||---XXXXXXXXXXXXXXXXXXXXXXXXXXXXXXXXXXXXXXXXXXXX-------------|%||-----||||-XXXXXXXXXX---||------XXXXXX