------------------------------------------------------------------------------------------------------------------------------------------------------
------------------------------------------------------------------------------------------------------------------------------------------------------
------------------------------------------------------------------------------------------------------------------------------------------------------
------------------------------------------------------------------------------------------------------------------------------------------------------
-------------g---------------------------------------------------------------------------------------------g-g----------------------------------------
---------%%%%%%%-----------------------------------------------------------------------------oo----------%%%%%----------------oo--------oooo----------
----------||||--------------------------------------------------------------------------------------------||-----%%%%SS-------------------------------
----------||||-----#--------------------------oo-------------------------------------oo-------------------||------||---------------SSS----------------
----------||||-----------------------%%%%%%-------------------------------------------------------%%%%%---||------|||----------S------------S---------
-----------|||--------oo--------------||||---------------#---------------------------------------%%|||----||------||||----------S-----------SS--------
---%%%%----|||-##---%%%%--------------|||----------------#----------------------------------------||||----||------||||%-------------------------------
----|-------||##-----|----------------||-----------------##---------oo---------------------------|||||-%%%%%------||||--------------------------------
----|-------||||-----|-------SS-SS----||-----------------##---------------------------------|%---|||||--|||----|--||||--------------------------------
---------#--#|||----||----------------||-----r-----------##---------------------------------||---|||||--|||---||---|||-----%%%-----ooo-------r--------
XXXXXXXXXXXXXX||----||-|--------------XXXXXXXXXXXXXXXXXXXXX--%%%%X%%-X%%----%%%--%------X---||---|||||--||----||---|||------||---%%%%%--XXXXXXXXXXXXXX
XXXXXXXXXXXXXX||----|--|--------------XXXXXXXXXXXXXXXXXXXX-----|%%|---||-----|----------|---||---|||||--||----||----||------||----%||---XXXXXXXXXXXXXX