------------------------------------------------------------------------------------------------------------------------------------------------------
------------------------------------------------------------------------------------------------------------------------------------------------------
------------------------------------------------------------------------------------------------------------------------------------------------------
------------------------------------------------------------------------------------------------------------------------------------------------------
-----------------------------g------------------------------------------------------------------------------------------------------------------------
--oo-----------------------%%%%-----oo----o-----------------------------------------o-%-------------oo------%-------oo----------oo--------------oo----
-------------------------------------------SS---------S--------------------------%%%%%%----------%%%%----------------------SSSS--S--------------------
---------------------------------------------------%%%%---------------------------||||------------||-------------SSSS-----------------%%%%%-----------
--------------------%%%%%%%%%-----------------------||----------------------------||||------------||-------%%%-----------------------|||||------------
---------------------|||||||------------oo----------||-----------#----------------||||-%%%--%-----||--------|--------------------%%%%||---------------
-------%%%%----------|||||||------%%%-----%%S----%%-||-----------##-------%%%%%---||||-||%%%%-----||--------|--------------%%%%---|||||---------------
--------||------------||||||------||--------------|-||------------#--------|||----||||||||||------||--------|---------------||----||||||--------------
--------||-----%%%----||||||--%%--||--------------||||----------------------||----||||||||||------||--------|---------------||----||||||--------------
--------||-----||-----||||||--||--||--------------||||----------------------||----||||||||||------||------------------------||----||||||--------------
--------||--%%|-|-----||||||--||--||---%%%%%%%----||||-------XXXXXXXXX------||----||||||||||------||--------XXXXXXXXXX----%-||----||||||XX------XXXXXX
--------||---%|-|-----||||||--||--||----||||------||||-------XXXXXXXXX------||----||||||||||------||--------XX-XXXXXXX------||----||||-|--------XXXXXX