------------------------------------------------------------------------------------------------------------------------------------------------------
------------------------------------------------------------------------------------------------------------------------------------------------------
------------------------------------------------------------------------------------------------------------------------------------------------------
------------------------------------------------------------------------------------------------------------------------------------------------------
-----------------------------------------------------------------------------------g------------------------------------------------------------------
-------oo-------------------oooo---------Xoo----------------#--------------------%%%%---------oo------------------------------------------------------
--------------%%%%--%%%%-------%%%%-------%%-------------####---------------------||------------------------------------------------------------------
--------------|-|-----|---------||--------|--------------####---------------------||--------------------------------oo--------------------------------
--------------||||--%%%%%%------||--------|-------------#####------------------%%%%%%----%%%%%%----------%%%%%%---------------------------------------
--------------||||--|||||-------||-----------o----------###-#-------------------||||------||||------------||||--------------oo------------------------
---------#----||||--||||||-%%%%-|%%%%----%%%%%----------##---------SSSS--%%%%---||||------||||------------||||----------------------------------------
----------------||--||||||------||||------||----%%%-----##----------------||----||||-|----||||------------||||----------------------------------------
-----------------|--||||||------||||------||-|--||------##----------------||----||||-|----||||----%%%%%---||||-------------------%%%%-----------------
---------#-------|--||||||------||||------||-|--||-------#--------------o-||-----|||-|----||||----||||----||||--------------------||------------------
XXXXXXXXXXXXXXXXXX%-||||||%---%%%|||------||-|--||----XXXXXXXXX---------%-||------||||XXX-||||----||||----||||------%%%-----------||--------XXXXXXXXXX
XXXXXXXXXXXXXXXXXX--||||||-----%||||------||-|--||-|--XXXXXXXXX---------|-||------||X|XXX-||-|----||||----||||-------||-----------|---------XXXXXXXXXX