----------------------------------------------------------------------------------------------------------------------------------------------------------------------------------------
----------------------------------------------------------------------------------------------------------------------------------------------------------------------------------------
----------------------------------------------------------------------------------------------------------------------------------------------------------------------------------------
----------------------------------------------------------------------------------------------------------------------------------------------------------------------------------------
----------------------------------------------------------------------------------------------------------------------------------------------------------------------------------------
----------------------------------------------------------------------------------------------------------------------------------------------------------------------------------------
------------------------------##-------------------------------SSo-----------------------#---------y---------------------------------------------#-y------------------------------------
---------------------y-y----------------------------------------------------------------##------------------------------------------------------##SS-------------------------y----------
----------S----------#SS---------------------------------------------------------------###-----------------------------------------------------###-------------------------#SS----------
-----###------------##-----------------------------------------------------------------###----------------------------------------------------####------------------------##------------
------##-----------###--SC---#-###----------------------##--------------------QQ-------###----------##-SSSSC---------------------------------#-###-----------------------###------------
--#--###-----------###------#------------------###---#-###-----------------------------###--------###--------------------------TTT---------y#-####--SSSS----------------####------------
--#--###-----------###--#SSS----------------#--###---#-#-#---------------------------#####-------------------------------------TT----------##-####---------------------#####------------
-----###---S------####---------------y---------#-#-----#-#-------------------y--------####-----------------------------y---y---T----------###-####--------------------######----SS------
--XX-XXX------XX--XXXX---------XXXXXXXXXXXXXXXXXXX-XX---XXXXXXXXXXXXXXXXXXXXXXXXXXXXXXXXXXXXXXX---XXXXXXXXXXXXXXXXXXXXXXXXXXXXXXXXXXXX--XXXXXXXXXX--XXX--XXXXXXXXXXXXXXXXXXX------------
--XXXXXX------XX--XXXX--------XXXXXXXXXXXXXXXXXXXX-XXX--XXXXXXXXXXXXXXXXXXXXXXXXXXXXXXXXXXXXXXX---XXXXXXXXXXXXXXXXXXXXXXXXXXXXXXXXXXXX--XXXXXXXXXX--XXXXXXXXXXXXXXXXXXXXXXXX------------