----------------------------------------------------------------------------------------------------------------------------------------------------------------------------------------
----------------------------------------------------------------------------------------------------------------------------------------------------------------------------------------
----------------------------------------------------------------------------------------------------------------------------------------------------------------------------------------
----------------------------------------------------------------------------------------------------------------------------------------------------------------------------------------
----------------------------------------------------------------------------------------------------------------------------------------------------------------------------------------
----------------------------------------------------------------------------------------------------------------------------------------------------------------------------------------
-----------------------------------------------------y--Sy----------------------------2-------------------------oo----------------------------------------------------------------------
-----------------------------------------------------###SS-ooo--------------------------------------------------------------#S-ooo-----------------##SS---------------------------------
-----y----------------------------------------------###--------------------------------------------------------------------##----------------------##-----------------------------------
-----###--------------------------------------------####------------------------------------------------------------------###---------------------####---------------------------y------
----####---------------------------#------oo-----y---###-------------------------------------------##--SSC---###---------####--------oS----------#-###--------------##----------##------
---#####-------------------------#---------------##--###--SSSSS-----------------------------------#---------###---------####----SSS-------------#--###-----------y-###---------###------
---###---------------------------#--------------###--###-----------------------------------------##------SS-###--------#####-------------------##--###-----------#####-------#####------
--####-----------------y--------#---------------###--###-----------y-----------------------S----##----------###-------#-#-##-------------y----###-####---S-----#####--------######------
XXXXXX----XXXXXXXXXXXXXXXXXXXXXXXXXXXX--XXXXXX--XXX--XXXXXXXXX--XXXXXXXXXXXXXXXXXXXXXXXX--XXXXXXXXXXXX---XXXXXXXXX--XXXXXXXXXXXX---X-XXXXXXXXXXXXXXXXX----XXXXXXXX--XXXXXXXXXXXXXXXXXX--
XXXXXX----XXXXXXXXXXXXXXXXXXXXXXXXXXXX--XXXXXX--XXXX-XXXXXXXXXXXXXXXXXXXXXXXXXXXXXXXXXXX--XXXXXXXXXXXX--XXXXXXXXXX--XXXXXXXXXXXX---XXXXXXXXXXXXXXXXXXX----XXXXXXX---XXXXXXXXXXXXXXXXXXX-