----------------------------------------------------------------------------------------------------------------------------------------------------------------------------------------
----------------------------------------------------------------------------------------------------------------------------------------------------------------------------------------
----------------------------------------------------------------------------------------------------------------------------------------------------------------------------------------
------------------------------------------------------------------------------------------------------------SS--------------------------------------------------------------------------
----------------------------------------------------------------------------------------------------------------------------------------------------------------------------------------
----------------------------------------------------------------------------------------------------------------------------------------------------------------------------------------
-----------SSSS--------###-------------------------y---------------------------------y-y-----------------###----------------------------------------------------------------------------
----------------------####-------------------------#SS-oo----------------------------#SS----------------###-----SS----------------------------------------------------------------------
----------------------####-------------------------#-------------------------------###-----------------###-----SS-------------------------------------------------y---------------------
----------------------####---------------------------------------------------------###----------------#--#-----S------------------------------------------------------------------------
-----------###-SSC----####-------------oo--------#---###S--------------------------###-------#-------#-------#-----------------------#Q----------------------#--------------------------
---------S-###------######----------------------#######----------------------------###--SS---------y##--##-#-#---------------------------------------------y##--------------------------
---------#####------#-###----------##-----------#####----------------------------#####-------------###--#----#----SSS--------------------------------------###----SS--------------------
--------######------#-###----------------------#-###---------------------------#######------------##--------##---S---------y---------------y--------------####---------------T----------
XXXXXXXXXXXXXX-XXXXXXXXXXXXXXXXXXXXX---X--XXXXXXXXXXXXXX--XXXXXXXXXXXXXXXXXXXXXXXXXXXXXX---XXXXXXXXXXXX----XXX------XXXXXXXXXXXXXXXXXXXXX-XXXXXXXX-----XXXXXXXXX------XXXXXXXXXXXXXXXX--
XXXXXXXXXXXXXXXXXXXXXXXXXXX-XXXXXXXX------XXXXXXXXXXXXXX--XXXXXXXXXXXXXXXXXXXXXXXXXXXXXX---XXXXXXXXXXXX---XXXX------XXXXXXXXXXXXXXXXXXXXXXXXXXXXXX-----XXXXXXX-X------XXXXXXXXXXXXX-XX--