----------------------------------------------------------------------------------------------------------------------------------------------------------------------------------------
----------------------------------------------------------------------------------------------------------------------------------------------------------------------------------------
----------------------------------------------------------------------------------------------------------------------------------------------------------------------------------------
----------------------------------------------------------------------------------------------------------------------------------------------------------------------------------------
----------------------------------------------------------------------------------------------------------------------------------------------------------------------------------------
----------------------------------------------------------------------------------------------------------------------------------------------------------------------------------------
-----------------------------#####-------------------------------SS--------------------------S------------------------------------------------------##S-----------yo--------------------
----------------------------####---------------y--------------SS------------------------------------------------------------------------------------##----------#SS---------------------
-------------------o---------------------------#-------------#-----------------------------##-----------------------------------------------------y-##----------#-----------------------
----------------------------------------------##------------##----------------------------###-------------------------------------------------------##---------##1----------------------
-------y-##------#-----------#--SS---------#-###-----------###----ooQQQ-------------------##---------------------------y----o------------------y-#--##---------##-----------------------
-------####-----------------###------------#####-----------###--------------------------####---------------------------#------------------------######--------###-----------------------
------###-----##-----------####----------#######--------y-####-------------------------#####--------------------------#----------------------#########--------###-----------------------
-------####--#------------#####---------########--------######-----------y-----y------######---------y-----y---y---y------------------------######-###--------###----------------y------
XX--XXXXXXXX-----XXX--XXXXXXXXXXXXX-XXXXXXXXXXXX------XXXXXXXX--XXXXXXXXXX-XXXXXXXXXXXXXXXXXXXXXX-XXXXXXXXXXXXXXXXXXXXXXXXXXXXXXXXXXXXXXXXXXXXXX---XXXXXXXXXXXXXXX--XXXXXXXXXXXXXXXXXXXX
XX--XXXXXXXX-----XXX--XXXXXXXXXXXXX-XXXXXXXXXXXX------XXXXXXXX--XXXXXXXXXXXXXXXXXXXXXXXXXXXXXXXXXXXXXXXXXXXXXXXXXXXXXXXXXXXXXXXXXXXXXXXXXXXXXXXXXX-XXXXXXXXXXXXXXX--XXXXXXXXXXXXXXXXXXXX