----------------------------------------------------------------------------------------------------------------------------------------------------------------------------------------
----------------------------------------------------------------------------------------------------------------------------------------------------------------------------------------
----------------------------------------------------------------------------------------------------------------------------------------------------------------------------------------
----------------------------------------------------------------------------------------------------------------------------------------------------------------------------------------
----------------------------------------------------------------------------------------------------------------------------------------------------------------------------------------
----------------------------------------------------------------------------------------------------------------------------------------------------------------------------------------
------------------------------##SS--------------------------------------------------------------------------------------------------------------oo-----------------------###------------
---------------------y-------#------------------------------------------------------SS-----------------------------------------------------------------------------------###------------
---------------------------#SS-----------------------#-----S----------y------------#---------SS-----------------y--------------------------------------------------------###------------
--------------------------##------------------------##-----SS----------------------#----------------------------#--------------------------------------------------------###------------
--------------------------##-----------------------##----#--CC-------#-------------------#--------------------###------------###--SC--oo----ooo-----------------------#--###------------
-------------------###-#####----------------------####-###----------###--------y-###------------------------#####-------#---###--------------------------------------#-----#------------
---------------#######-#####---------------------#####--------SS---###---------#####-----------------------######------##---###-------------------------------------------##------------
--------------#####-##---#-----SSS----------y---######------------####--------####-------------------y----#######-------#---####-----------y--------y--y------------------####----------
-XXX--XX--XXXXXXXXX-XX------------XXXXXXXXXXXXXXXXXXXX-XXX--XX-XXXXXXX----XXXXXX---X--XXX-XXXXXXXX--XXXXXXXXXXXXX---XX--XXXXXXXXXXXXXXXXXXXXXXXXXXXXXXXXXXXXXXXXXX--XXX-XXXXXX-XXX--XX--
-XXX--XX--XXXXXXXXXXXX------------XXXXXXXXXXXXXXXXXXXX-XXX--XXXXXXXXXX----XXXXXXX-XX--XXXXXXXXXXXX--XXXXXXXXXXXXX---XX--XXXXXXXXXXXXXXXXXXXXXXXXXXXXXXXXXXXXXXXXXX--XX--XXXXXX-XXX--XXX-