----------------------------------------------------------------------------------------------------------------------------------------------------------------------------------------
----------------------------------------------------------------------------------------------------------------------------------------------------------------------------------------
----------------------------------------------------------------------------------------------------------------------------------------------------------------------------------------
----------------------------------------------------------------------------------------------------------------------------------------------------------------------------------------
----------------------------------------------------------------------------------------------------------------------------------------------------------------------------------------
----------------------------------------------------------------------------------------------------------------------------------------------------------------------------------------
-----------------------------------------------------------------------------------------------------------------------------------------------------------------------------------##---
-----------o-----------------------------------------------------------------------------------------------------------------------------y----------------------------------------##----
--------------------------------------------------------y-------------------------------------------------------------------------------##---------------y-----------------------###----
-----------------------y-------------------------------#SS--------------------------------------------------------##------------------#-##-----o---------#-----------------------###----
-----###--SC--------------#--------#--------##--------##--------------------------------So--Q--------------------###-------#---------##-----------------##---------------------#--##----
-----#-#-------------####---------##-------###--------##-----------------------------T-------------T-------TT---####----------------####-#------------####-----------------y-----###----
-----------SSS-------###----------#-------####-------###-----------SS---------------TTT-----------TT-------T---#####-------#-------####---------------####-----------------###---###----
------------------##-##----------------S--####------####---S-------------------------TT--------y--TT-------#########--------------#####-------------####-#----------------###----###----
XX----XX------XXXXXXXXXXXXXXXXXXXXXXXX--XXXXXX--XX--XXXX------XX-------XXXXXXXXXXXXXXXXXXXXXXXXXXXXXXXXXXXXXXXX--XXX--XXXXXXX-XX--XXXXX-----XX--XXXXXXXXXX-XXX--XXXXXXXXXXXXXXXX-XXXXXXX
XX----XX------XXXXXXXXXXXXXXXXXXXXXXXX--XXXXXX--XX--XXXX------XX-------XXXXXXXXXXXXXXXXXXXXXXXXXXXXXXXXXXXXXXXX---XX--XXXXXX--XX--XXXXXX----XX--XXXXXXXXXXXXXX--XXXXXXXXXXXXXXXXXXXXXXXX