----------------------------------------------------------------------------------------------------------------------------------------------------------------------------------------
----------------------------------------------------------------------------------------------------------------------------------------------------------------------------------------
----------------------------------------------------------------------------------------------------------------------------------------------------------------------------------------
----------------------------------------------------------------------------------------------------------------------------------------------------------------------------------------
----------------------------------------------------------------------------------------------------------------------------------------------------------------------------------------
----------------------------------------------------------------------------------------------------------------------------------------------------------------------------------------
------------oo---------------------------S------------------------------y-----------------------------------oo------S-----------------2-------------------------------------------------
--------#S-----------------------------------------------------------------------------y------------------------------------------------------------------------------------------------
-------##------------------------------------------------------------------------------#------------------------------------------------------------------------------------------------
------###1-------------------------------------------------------------###------------##--------------------------------------------------------Q---------------------------------------
-------#---SSC-------------o-------------###---------------#-----------###-----------###--------------##--##########S----------------------------------------------------o--------------
-------##-----------------------------#-####---y---y------##--------y--###---------#####------------####--##--##------------------------------------------------------------------------
-----####-----SS---------------------#######---S-----########----------###--------####-#-----------#####--------------------------------------------------------------------------------
------###------------y--------------#######----S--###---##-------S-----###-------##---------------#####------------------------y----------------SSSS-----------------------------y------
XXXXXXXXXX------XXXXXXXXXXXXXXXXXXXXXXXXXX--------XX----------------SXXXXXXXXXXXXX---XXXXXXXXXXXXXXXXXXX-XXXXXXX--XXXX--XXXXXXXXXXXXXXXXXXXXXX-----XXXXXXXXXXXXXXXXXXXXXXXXX--XXXXXXXXXX
XXXXXXXXXX------XXXXXXXXXXXXXXXXXXXXXXXXXX--------XX----------------XXXXXXXXXXXXXX---XXXXXXXXXXXXXXXXXXX-XXXXXX---XXXX--XXXXXXXXXXXXXXXXXXXXXX-----XXXXXXXXXXXXXXXXXXXXXXXXX--XXXXXXXXXX