----------------------------------------------------------------------------------------------------------------------------------------------------------------------------------------
----------------------------------------------------------------------------------------------------------------------------------------------------------------------------------------
----------------------------------------------------------------------------------------------------------------------------------------------------------------------------------------
----------------------------------------------------------------------------------------------------------------------------------------------------------------------------------------
----------------------------------------------------------------------------------------------------------------------------------------------------------------------------------------
----------------------------------------------------------------------------------------------------------------------------------------------------------------------------------------
-------------SSS---------------#SS----------------SS-----------------------------------#---------------yy----------------------------oo-------------------------------------------------
-----------------------------------------------------------------------------------------------------##SS-------------------------------------------------------------------------------
-----------------y-----------------------------------------------------------oo----------U----------###--------------------------------------S------------------------------------------
-----------------#SS-------------------y------------------------------------------------##----------###-------------------------------------#S------------------------------------------
-------------y--##---------####--------###--------##---SC-----------------S#oo---------###----------###------------------oo----------------##-------Q------------###--------------------
-------------#-###--------##----------##---------###----------------------------------###---------#-###---SS----------------------T-------####------------------###----S----------------
------------##-###-------------------###---------###----SSS--------------------------####---------#-###--------------##-----------T------#####-----------------####---------------------
---------------###-------------------------------###-----------------T--------------#####--------#--###-------------##------------T-----######---------------######---------------------
XXXX----XXXXXXXXXX--XX----XXXXXXXX--XXXXXXXXXXXXXXXXXX-----XXXXXXXXX--XXXXXXXXXXXXXXXXXXXXXX--XXXXXXXXXX--X---XXXXXXXX--XX----XXXXXXXXXXXXXXXXXX--XXXXX--XXXXXXXXXXX--XX--XX--XXXXXXXXX-
XXXX----XXXXXXXXXX--XX----XXXXXXXX--XXXXXXXXXXXXXXXXXX-----XXXXXXXXX-XXXXXXXXXXXXXXXXXXXXXXX--XXXXXXXXX---XX--XXXXXXX----X----XXXXXXXXXXXXXXXXXX--XXXXX-XXXXXXXXXXXX--XX--XX--XXXXXXXXX-