----------------------------------------------------------------------------------------------------------------------------------------------------------------------------------------
----------------------------------------------------------------------------------------------------------------------------------------------------------------------------------------
----------------------------------------------------------------------------------------------------------------------------------------------------------------------------------------
----------------------------------------------------------------------------------------------------------------------------------------------------------------------------------------
------------------------------------------y---------------------------------------------------------------------------------------------------------------------------------------------
----------------------------------------#SSS--------------------------------------------------------------------------------------------------------------------------------------------
------------------------------SS-------##--------------------------------###---------------------------------------------------------US-y--------------------------------#SS------------
---------------------------------------##1-------------------------------#-----------------------------------------------------------##--ooo-----------------------------#--------------
----------------------------------------#-------------------------------------------------y-----------------------------------------##1--------------------------------#-y--------------
--------------------------------------------SS----------------##------------------------#SS------------------------------#----------###1------------------------------##----------------
-------------##-----2SS----Q-------------#-----------------#-###---------S-----------#-##---SC------------##------------##--SC------###-------o----------------#-----###---#----S-------
------------##--------------------------####---------------#####--------------------#####---------------T#-#-----------###----------###--SSS------------------##----####-#--------------
---------y-##------------------------#-#####--------------######------------------######-----SSS-----y--T#-#----------####----SS----####---------------------###---#####----------------
----y----###-#-------------------------###-#------------########-------------y---#######------------#---T###--------######----------###--------------y------####--######-----------y----
XXXXXXXXXXXXXXXXXXXXXXXXXXXXXXXXXXXXXXXX---------XXXXXXXXXXXXXXX----XXXXXXXXXXXXXXXXXXXX--------XXXXXXXXXXXXXXXXXX--XX--XX--XX--XXXXXXXXXXXX--XXXXXXXXXXXXXXXXXXXXXXXXXXXXXX---XXXXXXX--
XXXXXXXXXXXXXXXXXXXXXXXXXXXXXXXXXXXXXXXXXX-------XXXXXXXXXXXXXXXX---XXXXXXXXXXXXXXXXXXXX--------XXXXXXXXXXXXXXXXXX--XX--XX--XX--XXXXXXXXXXXXX-XXXXXXXXXXXXXXXXXXXXXXXXXXXXXX---XXXXXXXX-