----------------------------------------------------------------------------------------------------------------------------------------------------------------------------------------
----------------------------------------------------------------------------------------------------------------------------------------------------------------------------------------
----------------------------------------------------------------------------------------------------------------------------------------------------------------------------------------
----------------------------------------------------------------------------------------------------------------------------------------------------------------------------------------
----------------------------------------------------------------------------------------------------------------------------------------------------------------------------------------
-----------------------#----------------------------------------------------------------------------------------------------------------------------------------------------------------
----------------------##----------------------------------------------------------------------------------------------------------------------------------------------------------------
---------------------###------------------------------------------------------------------------------------------------------------------------------------------------TT--------------
--------#------------###----------------------------o-------------------------------------------------------------------------------------------------------------------TT--------------
-------###-----------###-----------------------------------------------------------------------------------------------------------------------------------------------#SS--------------
-------##----SSC------##----------------------SC---------------#---------------------SSS-------###--------y----------------------------------------------------------###----------------
-------###---------#-####----------#-------#------------------##--------------------##--------###----------#-----------------------------------------------TTT-----#-###----------------
----######-----SSS#---####--------##------##---SSSy----------###-------------------###-------####---------#------------------------------------------------TT-----######----------------
----######------------####-------###---SS###-------S--------####---------y--------####------####---------#-#--------------------------------------------y--TT----#######--SS------------
XXXXXXXXXXXX-----XXXXX-XXXXXXXXXXXXX----XXXX-------XXXXXXXXXXXXXXXXX--XXXXXXXXXXXXXXXXXX--XXXXXXXXXX--XXXXXX--XX--XX--XXXXXXXXXXXXXXXXXXXXXXXXXX--XXXXXXXXXXXXXXXXXXXXXX------XXXX--XX--
XXXXXXXXXXXX-----XXXXXXXXXXXXXXXXXXX----XXXX-------XXXXXXXXXXXXXXXXX--XXXXXXXXXXXXXXXXXX--XXXXXXXXXX--XXXXXX--XX--XX--XXXXXXXXXXXXXXXXXXXXXXXXXX--XXXXXXXXXXXXXXXXXXXXXX------XXXX--XX--