------------------------------------------------------------------------------------------------------------------------------------------------------------------------------------------------------
------------------------------------------------------------------------------------------------------------------------------------------------------------------------------------------------------
------------------------------------------------------------------------------------------------------------------------------------------------------------------------------------------------------
------------------------------------------------------------------------------------------------------------------------------------------------------------------------------------------------------
------------------------------------------------------------------------------------------------------------------------------------------------------------------------------------------------------
------------------------------------------------------------------------------------------------------------------------------------------------------------------------------------------------------
----------------------------------------------------------------------T-------------------------------------------------------------------------------------------------------------------------------
----------------------------------------------------------------------TT------------------------------------------------------------------------------------------------------------------------------
----------------------------------------------------------------------T#------------------------------------------------------------------------------------------------------------------------------
------------------------------------------------------------------------------K-----------------------------------------------------------------------------------------------------------------------
------------#LSS-----------------------------------#-----------------------------------------------------------------------------------------------------------------------#--------------------------
------------#--------------------K-----------------#-----------TT-------------------------------------------------------------------------------------------TT------------##--------------------------
------------#--T------------------------------*----#------------T----------------*--------------------------------------------------------------------------TT-----------###--------------------------
--gg--------#-TT-------ggg--------------------*----##-----TT----T----------------*--------ggg----------ggg----------k----ggg--k--gg------ggg-------ggg----kkTT-g--------####----gg----ggg--k----ggg---
XXXXXXXXXXXXXXXXXXXXXXXXXXXXXXXXXXXXXXXXXXXXXXXXX--XXXX---XXXXXXXXXX--XXXXXXXXXXXXXXXXXXXXXXXXXXXXXXXXXXXXXXXXXXXXXXXXXXXXXXXXXXXXXXXXXXXXXXXXXXXXXXXXXXXXXXXXXXXXXXXXXXXXXXXX--XXXXXXXXXXXXXXXXXXXXXX
XXXXXXXXXXXXXXXXXXXXXXXXXXXXXXXXXXXXXXXXXXXXXXXXX--XXXXX--XXXXXXXXXX--XXXXXXXXXXXXXXXXXXXXXXXXXXXXXXXXXXXXXXXXXXXXXXXXXXXXXXXXXXXXXXXXXXXXXXXXXXXXXXXXXXXXXXXXXXXXXXXXXXXXXXXX--XXXXXXXXXXXXXXXXXXXXXX