------------------------------------------------------------------------------------------------------------------------------------------------------------------------------------------------------
------------------------------------------------------------------------------------------------------------------------------------------------------------------------------------------------------
------------------------------------------------------------------------------------------------------------------------------------------------------------------------------------------------------
------------------------------------------------------------------------------------------------------------------------------------------------------------------------------------------------------
------------------------------------------------------------------------------------------------------------------------------------------------------------------------------------------------------
------------------------------------------------------------------------------------------------------------------------------------------------------------------------------------------------------
-------------------------------------------------------------------------------------------------------------------#--------------------------------------------------------------TT-----------SSS----
------------------------------------------------------------------------------------------------------------------##--------------------------------------------------------------TT---------#--------
--------------------------T------------------------------------------------------------------S--------------------##--------------------------------------------------------------##-SUS----##--------
--------------------------T---------------------------------------------------------------------------------------##------------------------------------------------------------------------#---------
--------------------------#------------------------------------------------------------------------------------#--##--#---##-------------------------------------------------------------#####--------
-----------#--------------------------------------------------------------------------------------------------#---##---#--##---------------------------------------------------------#---#------------
-----------#-----------------------------------------------------*-------------------------------------------K#---*----#------------------------------TT-------*----------*---------##--##------------
------*----#-----------------ggg----------#------gggg------------*---------*---gg-----------ggg------ggg------#---*----#-------------ggg------ggg-k---TT-------*--------------------##--##---ggg------
XXXXXXXXXXXXXX--XXX-----XX--XXXXXXXXXXXXXXXXXXXXXXXXXXXXXXXXXXXXXXXXXXXXXXXXXXXXXXXXXXXXXXXXXXXXXXXXXXXXXXXXXXXXXXXXX--XXX---XXXXXXXXXXXXXXXXXXXXXXXXXXXXXXXXXXXXXXXXXXXXXXXX---XXXXXX---XXXXXXXXXXXXX
XXXXXXXXXXXXXX--XXX-----XX--XXXXXXXXXXXXXXXXXXXXXXXXXXXXXXXXXXXXXXXXXXXXXXXXXXXXXXXXXXXXXXXXXXXXXXXXXXXXXXXXXXXXXXXXX-XXXX---XXXXXXXXXXXXXXXXXXXXXXXXXXXXXXXXXXXXXXXXXXXXXXXX---XXXXXX---XXXXXXXXXXXXX