------------------------------------------------------------------------------------------------------------------------------------------------------------------------------------------------------
------------------------------------------------------------------------------------------------------------------------------------------------------------------------------------------------------
------------------------------------------------------------------------------------------------------------------------------------------------------------------------------------------------------
------------------------------------------------------------------------------------------------------------------------------------------------------------------------------------------------------
--------------------------------------------------------------------------------------------------------------------------------------------------------------------------------------##--------------
--------------------------------------------------------------------------------------------------------------------------------------------------------------------------------------##--------------
-----------------------------------------#-----------------------------------------------------------------------------------------------------------------------------------SUS--##--##--------------
----------------------------------------##---------------------------------------------------------------------------------------------------------------------------------------###--##--------------
----------------------------------------##----------------------------------T--------------------------------------------------------------------------------------------SUS-----###------------------
----------------------------------------##----------------------------------TT--------------------------------------------------------------------------------------------------####------------------
-------------------------------------#--##------------------------#LS-------TT--------------#-SS-----------------------------------------------------------------------------#######------------------
------------------TT-----------T-----#--##------------------------#----------T--------------------------------------------------------T------------------------------------########-------------------
-------*----------TT----TT-----T-----#--#-------------------------#-------------------------#-----------------------------------------T------------------------*---------######-##--------------------
-------*--gg----kkTT----TT-----------#----------------kgg-------k-#---------------------k---#-------g-g-----k-----------ggg---------k-T------------------------*--k------######-##--------------------
XXXXXXXXXXXXXXXXXXXXXXXXXXXXXXXXXXXXXXX----XXXXXXXXXXXXXXXXXXXXXXXXXXX----X---XXXXXXXXXXXXXXXXXXXXXXXXXXXXXXXXXXXXXXXXXXXXXXXXXXXXXXXXXXXX----XXXXXXXXXXX---XXXXXXXXXXXXXX--XX----------------XXXXXXXX
XXXXXXXXXXXXXXXXXXXXXXXXXXXXXXXXXXXXXXX-----XXXXXXXXXXXXXXXXXXXXXXXXXX----X----XXXXXXXXXXXXXXXXXXXXXXXXXXXXXXXXXXXXXXXXXXXXXXXXXXXXXXXXXX-----XXXXXXXXXXX---XXXXXXXXXXXXXX-XXX----------------XXXXXXXX