------------------------------------------------------------------------------------------------------------------------------------------------------------------------------------------------------
------------------------------------------------------------------------------------------------------------------------------------------------------------------------------------------------------
------------------------------------------------------------------------------------------------------------------------------------------------------------------------------------------------------
------------------------------------------------------------------------------------------------------------------------------------------------------------------------------------------------------
------------------------------------------------------------------------------------------------------------------------------------------------------------------------------------------------------
------------------------------------------------------------------------------------------------------------------------------------------------------------------------------------------------------
------------------------------------------------------------------------------------------------------------------------------------------------------------------------------------------------------
-------------------------------------------------------------------------------#----------------------------------------------------------------------------------------------------------------------
------------------------------------------------------------------------------##---------------------------SUS----------------------------------------------------------------------------------------
------------------------------------------------------------------------------##---------------------------------------------------T------------------------------------------------------------------
-----------------------------------------##--------------------------#-------###----------#------#--------------------------#LSS--##------------------------------------S-----------------------------
----------------------------------------#---------------------------##---#----##-----------------#--------------------------#---------------TT--------------------------------------------------------
-----------------------------------------#-------------------------###---#----##------------*----#--------------------------#---------------TT--------------------------------------------------------
----gg-------------gg----------------K---#---gg----gg-----ggg-----####----#---##------------*----#-----------------gg-----kk#----------*--kkTT-----g---ggg-----ggg--g------------ggg------------------
XXXXXXXXXXXXXXXXXXXXXXXXXXXXXXXXXXXXXXXXXXXXXXXXXXXXXXXXXXXXXXXXXXXXXXXXXXXX-----XXXXXXXXXXXXXX-XXXXXXXXXXXXXX-XXXXXXXXXXXXXXXXX-----XXXXXXXXXXXXXXXXXXXXXXXXXXXXXXXXXXXXX----XXXXXXXXXXXXXXXXXX--XXXX
XXXXXXXXXXXXXXXXXXXXXXXXXXXXXXXXXXXXXXXXXXXXXXXXXXXXXXXXXXXXXXXXXXXXXXXXXXXX-----XXXXXXXXXXXXXXXXXXXXXXXXXXXXXXXXXXXXXXXXXXXXXXX-----XXXXXXXXXXXXXXXXXXXXXXXXXXXXXXXXXXXXX----XXXXXXXXXXXXXXXXXX--XXXX