------------------------------------------------------------------------------------------------------------------------------------------------------------------------------------------------------
------------------------------------------------------------------------------------------------------------------------------------------------------------------------------------------------------
------------------------------------------------------------------------------------------------------------------------------------------------------------------------------------------------------
------------------------------------------------------------------------------------------------------------------------------------------------------------------------------------------------------
------------------------------------------------------------------------------------------------------------------------------------------------------------------------------------------------------
----------------------------------------------------------------------------------------------------------------------##------------------------------------------------------------------------------
--------------------------------------------------------------------------------------------------------T--K------##--##------------------------------------------------------------------------------
------------------------------------------------------------------------------------------------------------------##--##------------------------------------------------------------------------------
-----------------------------------------------------------------------------------------------------------------------#------------------------------------------------------------------------------
--------------------------------------------------------------------------------------------------------------T--------#------------------------------------------------------------------------------
--------#LS---TT-----##---------------------#LSS------------------------------------------------------------####------###-----------------------------------------------------------------------------
--------#-----TT----------------------------#-------------------------T-----T-----------------------------------------##------------------------------------------------------------------------------
--------#-----TT---------------------*------#-----------------TT------TT----TT----------------------------------------##--------------------------------------------------TT--TT-----*----------------
--------#-----TT-----#------gg-------*----kk#---------k---*---T-------TT----TT--------------------------------------gg##---ggg---ggg---------------ggg-----K-------------gTT--TT-----*---------ggg----
XXXXXXXXXXXX--XXXXXXXXXXXXXXXXXXXXXXXXXXXXXXXXXXXXXXXXXXXXXXXXXXXXXXXXXXXXXXXXXXXXXXXXXXXXXX--XX--XXXXXXXXXX-----XXXXXXXXXXXXXXXXXXXXXX---XXX----XXXXXXX--XXXXXXXXXXXXXXXXXXXXXXXXXXXXXXXXXXXXXXXXXXXX
XXXXXXXXXXXX--XXXXXXXXXXXXXXXXXXXXXXXXXXXXXXXXXXXXXXXXXXXXXXXXXXXXXXXXXXXXXXXXXXXXXXXXXXXXXX--XX--XXXXXXXXXX-----XXXXXXXXXXXXXXXXXXXXXX---XXX----XXXXXXX--XXXXXXXXXXXXXXXXXXXXXXXXXXXXXXXXXXXXXXXXXXXX