------------------------------------------------------------------------------------------------------------------------------------------------------------------------------------------------------
------------------------------------------------------------------------------------------------------------------------------------------------------------------------------------------------------
------------------------------------------------------------------------------------------------------------------------------------------------------------------------------------------------------
------------------------------------------------------------------------------------------------------------------------------------------------------------------------------------------------------
------------------------------------------------------------------------------------------------------------------------------------------------------------------------------------------------------
------------------------------------------------------------------------------------------------------------------------------------------------------------------------------------------------------
-------------------------------#--##------------------------------------------------------------------------------------------------------------------------------------------------------------------
------------------------------##----------------------------------------------------------------------------------------------------------------------------------------------------------------------
------------------------------##----------------------------------------------------------------------------------------------------------------------------------------------------------------------
--------------------------##--##----------------------------------------------------------------------------------------------------------------------------------------------------------------------
--------------------------##--##--#-------------------------------------------------------------------------------------------------------------------------------------------------------------------
--------------T-----T------#---#----------TT------------------------TT------------------------------------------------TT------------------------------------------------------------------------------
--------------#-----T---------------TT----TT------*---TT------------TT------------------------------------------TT----TT------------------------------------------------------------------------------
-------------k------TT---------#----TT----TT------*---TT---ggg------TTg----K----------gg--k--------------gg-----TT--kkTT-------g-g-----------ggg-----ggg------g------------g---------ggg-------ggg----
XXXXXXXXXXXXXXXXXX---#----XXXXXXXXXXXXXX--XXXXXXXXXXXXXXXXXXXXXXXXXXXXXXXXXXXXXXXXXXXXXXXXXXXXXXXXXXXXXXXXXXXXXXXXXXXXXXXXXXXXXXXXXXXXXXXXXXXXXXXXXXXXXXXXXXXXXXXXXXXXXXXXXXXXXXXXXXXXXXXXXXXXXXXXXXXX
XXXXXXXXXXXXXXXXXX--------XXXXXXXXXXXXXX--XXXXXXXXXXXXXXXXXXXXXXXXXXXXXXXXXXXXXXXXXXXXXXXXXXXXXXXXXXXXXXXXXXXXXXXXXXXXXXXXXXXXXXXXXXXXXXXXXXXXXXXXXXXXXXXXXXXXXXXXXXXXXXXXXXXXXXXXXXXXXXXXXXXXXXXXXXXX