------------------------------------------------------------------------------------------------------------------------------------------------------------------------------------------------------
------------------------------------------------------------------------------------------------------------------------------------------------------------------------------------------------------
------------------------------------------------------------------------------------------------------------------------------------------------------------------------------------------------------
------------------------------------------------------------------------------------------------------------------------------------------------------------------------------------------------------
------------------------------------------------------------------------------------------------------------------------------------------------------------------------------------------------------
------------------------------------------------------------------------------------------------------------------------------------------------------------------------------------------------------
------------------------------------------------------------------------------------------------------------------------------------------------------------------------------------------------------
------------------------------------------------------------------------------------------------------------------------------------------------------------------------------------------------------
---------------------------------SUS----TT------------------------------------------------------------------------------------------------------------------------------------------------------------
----------------------------------------TT------------------------------------------------------------------------------------------------------------------------------------------------------------
-------------------------------------#--##--------------------------------------------------------------------------------------------------------------------------#-------------#-------------------
-----T----------------------------###----------------------------------------------------------#----------------------------------------------------------------------------------#---------K---------
---------------------------------#####-----*-------------------------------------------------###------------------------------------*----------------------------------------------------------------X
--kkT------ggg----ggg-----------######-----*------gggg-----ggg------gg----g---k-----gg----*-#-##-----------gg-----------gg---ggg----*----------ggg----gggg-----------g----------ggg------K----------XX
XXXXXXXXXXXXXXXXXXXXXXXXXXXXXXXXXXXXX-----XX--XXXXXXXXXXXXXXXXXXXXXXXXXXXXXXXXXXXXXXXXXXXXXXX-XXXXXXXXXXXXXXXXXXXXXXXXXXXXXXXXXXXXXXXXXX-XXXXXXXXXXXXXXXXXXXXXXXXXXXXXXXXXXXXXXXXXXXXXXXXXXXXXXXXXXXXX
XXXXXXXXXXXXXXXXXXXXXXXXXXXXXXXXXXXXX-----XX--XXXXXXXXXXXXXXXXXXXXXXXXXXXXXXXXXXXXXXXXXXXXXXXXXXXXXXXXXXXXXXXXXXXXXXXXXXXXXXXXXXXXXXXXXX-XXXXXXXXXXXXXXXXXXXXXXXXXXXXXXXXXXXXXXXXXXXXXXXXXXXXXXXXXXXXX