------------------------------------------------------------------------------------------------------------------------------------------------------------------------------------------------------
------------------------------------------------------------------------------------------------------------------------------------------------------------------------------------------------------
------------------------------------------------------------------------------------------------------------------------------------------------------------------------------------------------------
------------------------------------------------------------------------------------------------------------------------------------------------------------------------------------------------------
------------------------------------------------------------------------------------------------------------------------------------------------------------------------------------------------------
------------------------------------------------------------------------------------------------------------------------------------------------------------------------------------------------------
------------------------------------------------------------------------------------------------------------------------------------------------------------------------------------------TT----------
------------------------------------------------------------------------------------------------------------------------------------------------------------------------------------------TT----------
----------------------------------------------------------------------------##------------------------------------------------------------------------------------------------------------##----------
----------------------------------------------------------------------------##------------------------------------------------------------------------------------------------------------##----------
------------------------------------------------------#-------#####-----------------------------------------------------------------------------------------------------------------------##----------
------------------------------------------------------#------------------#---------------T--------------------#-----------------------T-----------------------------------------------#---------------
----------TT--------------------------------------------------------*----#----------------T------------------##----------------------------------------------------------------------K#------*--------
----------TT---ggg---------ggg-----gggg----ggg------k-#-------------*----#----------------T-----gg----------####--------------------k----------ggg-ggg-------gg---gg------------------#------*--------
XXXXXXXXXXXXXXXXXXXXXXXXXXXXXXXXXXXXXXXXXXXXXXXXXXXXXXXXXXX---XX---XXXX--XXXXXXXXXXXXXXXXXXXXXXXXXXXXXXXXXXXXXXXXXXXXXXXXXXXXXXXXXXXXXXXXXXX--XXXXXXXXXXXXXXXXXXXXXXXXXXXXXXXXXXXXXXXXXXXXXXXXXXXXXXXX
XXXXXXXXXXXXXXXXXXXXXXXXXXXXXXXXXXXXXXXXXXXXXXXXXXXXXXXXXXX---XX---XXXX-XXXXXXXXXXXXXXXXXXXXXXXXXXXXXXXXXXXXXXXXXXXXXXXXXXXXXXXXXXXXXXXXXXXX--XXXXXXXXXXXXXXXXXXXXXXXXXXXXXXXXXXXXXXXXXXXXXXXXXXXXXXXX