------------------------------------------------------------------------------------------------------------------------------------------------------------------------------------------------------
------------------------------------------------------------------------------------------------------------------------------------------------------------------------------------------------------
------------------------------------------------------------------------------------------------------------------------------------------------------------------------------------------------------
------------------------------------------------------------------------------------------------------------------------------------------------------------------------------------------------------
------------------------------------------------------------------------------------------------------------------------------------------------------------------------------------------------------
------------------------------------------------------------------------------------------------------------------------------------------------------------------------------------------------------
------TT---------------------------------------------------###----------------------------------------------------------------------------------------------------------------------------------------
------TT----K-----------------------------------------------------------------------------------------------------------------------------------------------------------------------------------------
----------------------------------------------------------#-----------------------------------------------------------------------------------------------------##------------------------------------
--------------------------------------------------------#-------------------------------------------------------------------------------------------------------##------------------------------------
------####---------------------------------------------#-------------------------------##-----------------####--------------------------TT-------------------#####----------#-------------------------
------#-------------------------------------TT--------##------------------------------##------------------#---------------T-------------TT----------------------##--------------------------#---------
------#----------T-----------------*---T-----T--------##-------------------------------#------------------#---------------TT--------------------------------##--#---------------------------------TT--
----kk#-----------T----ggg---------*---T---kTT-------##--------gg---ggg----ggg----#----#----------------kk#-------------k-T---------------------TT------###-------------ggg------ggg----g-k-------TT--
XXXXXXXXXX--XXXXXXXXXXXXXXXXXXXXXXXXXXXXXXXXXXXXXXXXXXXXXX---XXXXXXXXXXXXXXXXXXXXXXXXXXXXXXXXXXXXXXXXXXXXXXXXXX---XXXXXXXXXXXXXXXXXXXXXXXXXXXXXXXXXXXXXXXXXX---------XXXXXXXXXXXXXXXXXXXXXXXXXXXXXXXXX
XXXXXXXXXX--XXXXXXXXXXXXXXXXXXXXXXXXXXXXXXXXXXXXXXXXXXXXXX---XXXXXXXXXXXXXXXXXXXXXXXXXXXXXXXXXXXXXXXXXXXXXXXXXX---XXXXXXXXXXXXXXXXXXXXXXXXXXXXXXXXXXXXXXXXXX---------XXXXXXXXXXXXXXXXXXXXXXXXXXXXXXXXX