-----------------------------------------------------------------------------------------------------------------------------------------------------
-----------------------------------------------------------------------------------------------------------------------------------------------------
-----------------------------------------------------------------------------------------------------------------------------------------------------
-------------------------------------------------------------------------------------o---------------------------o---------------o-------------------
-----------------------------------------------------o------------------------------%%%-------------------------%%%----------------------------------
------o----o----------------------------------------%%%--------------o---------------|--------------------oo-----|-------------------------%%--------
----------%%%-------o--------------------------------|--------------%%%-o------------|--------------------%%%----|-%%%--------------------%%%--------
-----------|SS-----------------SS--------------------|---------------|--SSSS---------|---------------------|-----|-|S----------------------||--------
------SS---------%%%%--------------------------%%%%%-|---------------|-----------|---|---|---|-------------|-o-----|-------------------%%%-||--------
----------------SS||------SS--------SSS---------||||-|--S--------o---|-----------|---|---|---|-----o--SS---|-ro|---|---SSS--------------||-||--------
---------ro-------||------------------------%%%%||||-|----------%%%%-|-----------|--%%%--|---|------%------|-%%%%%-|---%%---------------||-||--------
-----%%%%%%%-------|-------------------------||-||||-|-----------||--|-----------|---|---|---|-%%%-%-------||-|||--|---||------------%%%%%|||--------
------||||||-------|-------------------------||-||||-|-----------||-%|%%---------||--|---|-%-||-||-|-------||%%%%%%%%--||-------------||||||%--------
------||||||%%---r-|--------------------%%%%-||-||||-|-----------||-|||----------||--|---||--||-||||-------||-||||||---||-------------||||||---------
XX----|||||||--%%%%%%%%%%%--XXXXXXXXXXX--||--||-|||----XXXXXXXXX-||-|||-------%%-||-||---||--|||||%----%%%-||-||||||---||--------X---|||||||-----XXXX
XX----|||||||---|-|||||||---XXXXXXXXXXX--||--||-||||---XXXXXXXXX-||-|||----------|||||---||-|||||||-----|--||-||||||---||------------|||||||-----XXXX