-----------------------------------------------------------------------------------------------------------------------------------------------------
-----------------------------------------------------------------------------------------------------------------------------------------------------
-----------------------------------------------------------------------------------------------------------------------------------------------------
-----------------------------------------------------------------------------------------------------------------------------------------------------
-------------------------------------------------------------------------------------------------------------------------------o---------------------
----------------%%-%%%%----------------------------------------o--------------------------------------------------------------%%%%-------------------
-----------------|--||---------------------------------o------%%%-----------------%%%%--------oSS------------------------------||--------------------
-------------o---|--||----------------%%%----------------------|---o--------------%||------------|------------------------o----||--oo----------------
------------%%%-||--||-----------------|-----------------------|---------------o---||-----%%%%-------------------------%%%%%%--||-%%%%%%%%%----------
-------------|--||--||----SS-----------|-o-------SSS-----------|---|-----------|---||------||--------------------o-----||--|---||--||-||||-----------
XX-----------|--||--||--------------r--%%%%--------------------|---------------|---||------||-------------------%%%----||-||---||--|||||||-----------
XX-----------|--||---|-----------%%%%%%|||---------------------|-------|-%%%%%%%%%-||------|---------------------||%%%-||--|---||--|||||||-----------
--------%%%%%%--||---|------------|||-||||----------------%%%%%%%------||-|||||||--||------|%%%------------------||||--||%%%%%-||%%%%%%%%%-----------
-X-------||-||--||----------------||||||-|-----------------||||||%%%%%-||-|||||||--|-----%%|||-------------------||||--||-||||-||||||||||------------
XXXXXXX--||-||--XXXXXXXXXXXXXXXXX|||||||%%%%%%%%%%---------|||||||||||-||-|||||||--|------||||------XXXXXXXXXXXXX||||-||%%%%%|-||||||||||--------XXXX
XXXXXX---||-||--XXXXXXXXXXXXXXXXX||||||||||||||||----------||||-||||||-||-|||||||--|------||||------XXXXXXXXXXXXXXX|||||||||||-||||||||||--------XXXX