-----------------------------------------------------------------------------------------------------------------------------------------------------
-----------------------------------------------------------------------------------------------------------------------------------------------------
-----------------------------------------------------------------------------------------------------------------------------------------------------
---------------------------------------------------------------------------------------------------------o-------------------------------------------
-----------------------------------------------------------------------------------------------------------------------------------------------------
---------------------------------------------------o-----------------------------------S----------------------------------------------------o--------
-----oooo-----------------------------------------%%%-------------%%%--o-----------------------------------------------------------o------%%%%-------
--------------SSS----------SS-oo-------o-----------|--------SSS----|--%%%--o-----SSS-------------SS---------------------SSSS---------------||--------
---%%%%%%%%-%---------------------%%%%%%%---------%%%--------------|---|--%%%--------------------------------------------------------------||--------
----||--||--|-------SSSSSS---------|--||-----------|---o-----------|---|---|S----------S-----SS--------------------------------------S-----||--------
----||--||--|----------------------|--||---%%------|------r-r------|---|---|----------------------------------r-r-%--------%---------------||--------
----||--||--|----------------------|--||---|-------|--%%%%%%-------|---|---|----------------------------%%%%%%%%%%%%-----------------------||--------
----||--%%%%%--------------------%%%%%%%%%-|-------|---||||--------|---|---|--%%--%-%--------------------||||||||||-------------------------|--------
----||--||||----------o-----------|||||||--|--%%%%-|---||||--------|---|---|--||---|%%%%%%%%%%%%%--------||-|||||||-------------------------%%%%-----
----||--||||-%%%%%----%XXXXXXXXXX-|||||||--|---||--|---||||-------%%%--|---|--||---|||||||||||||---------||-|||||||--------------------------||----XX
----||--||||--|||-------XXXXXXXXX-|||||||-||---||--|---|||---------|-|-|---|--||---|||||||||||||---------||-|||||||--------------------------||------