-----------------------------------------------------------------------------------------------------------------------------------------------------
-----------------------------------------------------------------------------------------------------------------------------------------------------
-----------------------------------------------------------------------------------------------------------------------------------------------------
-------------------------------------------------------------------------------------------------------------------------------------oo--------------
-----------------------------------------------------------------------------------------------------------------------------------------------------
---------------------------------------------------------------------------------o---------------------------o---------------o-----------------------
--------------oo-------------------------------------------oo-%%%------------o--%%%---------------------%%%%%%%%-o----------%%%%---------------------
--------------------------------SS------------------------%%%--|-----------------|---SS------------------||--||--o-----o-----||--o-------SSSS--------
-------%-------|-------------------------------------------|---|-----------------|--------------ooo------||--||-%%%%---------|--%%%------------------
-------|-------|--------------------SSS------o----%%%------|---|--SS-------------|-------SS--%-%%--------||--||--||----------|---|-------------------
-----%||------||------------------------------%----|-------|---|-----------------|-----------||||---%%%%-||--||--||----------|---|-------------------
------||------||-%%%%%%%%%%%---S-------%%%%--------|-------|-r-|------%%%%%%%%---|-----------||||-%--||--||--||%%%|%---------|---|-------------------
------||------||--||||||||||------------||---------|-------|%%%|%%%----||--||----|-----------||||-|--||%%%%%%%|||||%%%------%%%%---------------------
------||---r--||--|||||||||--r----------||---------|-------||--||-|----||--||----|-----------||||-|--||-|||||||||||||--------||--------------o-----o-
XXXX|-||-%%%%%%%%-|||||||||%%%%-------%%%|-----------XXXX--||--||------||--||----|--%%%------|||%%%%%%%%|||-|||||||||--------||-XXXXX--------------%%
XX-X|-||--|||||||-||||||||||||---------|||-------|---X-----||--||-|----||--|-----|--|||------||||||||||||||-|||||||||--------||-XXXX--X-------------X