-----------------------------------------------------------------------------------------------------------------------------------------------------
-----------------------------------------------------------------------------------------------------------------------------------------------------
-----------------------------------------------------------------------------------------------------------------------------------------------------
-----------------------------------------------------------------------------------------------------------------------------------------------------
-----------------------------------------------------------------------------------------------------------------------------------------------------
-------------------------------------------------------------------------------------------------o---------------------------------------------------
------------------------------o------------------o%------------------%%%-----------------------------------------------------------------------------
---------------------o---------SSS---SSS-----o---%-----SSSS----------|------SSSS------------------SS-------SSSSSS-------SSSS---------------SS--------
-------------------------------------------%%%%--|-------------------|%o-----------------------------------------------------------------------------
--------------------------SSSS---------------|---|-SSS------SSSS-----|---------o----SSS--------------SSSS--------------------------------------------
----------%%---------------------------------|-----------------------|--------%%%--------------------------------------------------------------------
----------||%%%%%%%%%%-----------------------|-----------------------|---------|------------------------------%%%%---------%%%%---------%%%%%%%%%%---
----------|||-||||||||--------------------%%%%%----------------------|----%%%--|%%%%%%%------------------------||-----------|------%-----||||||||----
----------|||-||||||||---------------------|||-----------------------|-----||%-|||||||--------------------%%%--||-----------|------|-----||||||||----
XXXXXXXX--|||-||||||||---------------------|||-----------------------%%%%%-||--|||||||-----XXXXXXXXX-----|||---||----XXXXXX|||----%%%%%%-||||||||----
XXXXXX-X--|||-||||||||---------------------|||------------------------||||-|||||||||||-----XXXXXXXX--------|---||----XXXXX-||-----|||||--||||||||----