-----------------------------------------------------------------------------------------------------------------------------------------------------
-----------------------------------------------------------------------------------------------------------------------------------------------------
-----------------------------------------------------------------------------------------------------------------------------------------------------
-----------------------------------------------------------------------------------------------------------------------------------------------------
-----------------------------------------------------------------------------------------------------------------------------------------------------
-----------------------------------------o------------%%%--------------------------o-------------------------------------o-------SS------------------
-----------------%%%---------------------%%%-----------|--------------------------%%%-----------------------------%%%--------------------------------
--------------%%%||-----SS----------------|--------|---|-o---------S---------------|-o------SSS----o-----o---------|--------SS-----------SSSS--------
-------%--%%-%%%|||-----------------------||---|--%%%-%%%%-------------------------|-------------%%%%-----------%%%%---------------------------------
-----------|--|||||-SS------SS------------||---|---|---||---SSS-------SSS------------SSSS--------|-|-------------|||----SSS-----SSSS-----------------
-----------|--|||||----------------------%|%---|---|---||----------------------------------------|-|--%-----%%%%-|||---------------------------------
---%%%%%%%%%%%%||||-------------------%%%|||---|---|---||----------------------------------------|||-----|---||--|||---------------------------------
----|||||-||||||||%%-------------------||||%|%%%%%-|---||--------------------%-%%%---------------|||-||------||-%|||---------------------------------
----|||||-|||||||||--------------------||||||-|||--|---||----------------o---|||-----------------|||-----|---||--|||-------------------%%%%----------
----|||||-||||||||||--------XXXXXXXXXX-||||||-|||-||-%-||--------------------|-|--------------|--|||%%%%%%%%-||--|%%%%%------%%---------||-------XXXX
----|||||-||||||||||--------XXXXXXXXXX-||||||-||||||-|-||--------------------|-|--------------|--|||||||||||-||--|||||-------||---------||-------XXXX