X----------------------------------------------------------------------------------------------------------------------------------------------------
-----------------------------------------------------------------------------------------------------------------------------------------------------
-----------------------------------------------------------------------------------------------------------------------------------------------------
---------------------------------------------------------o---o---------------------------------------------------------------------------------------
------------------------------------------------------------%%%--------------------------------------------------------------------------------------
------------------oo-----------------------------------------|-----------------------------------------------------------------------------o---------
---------------%%%%%%-o----|---------------------------------|--------------------------------------------------------------o----%%%%-----%%%%-------
---------o-----||-||--SS---|------SSSS-----------------------|---------o---------------------------SS--------------------o-------|||-------||--------
-------%%%%----|%%%%%------||--------------------------------|---------------So--------------------------SS-------------%%%%-----|||-------||--------
--------||-----|||||-------||-----------------SS----SSS------|-------------o--SS---------S---------------S--SSSSS--------||------|||-------||--------
--------||-----||||||------||%%------------------------------|--------------%--------------------------------------------||------|||--%%%--||--------
--------||-----||||||------||--o------------%%%--------------|-----%%%%%%%%%%--------------------|-----------------------||--o---|||---|---||--------
-----%%%%%%%-%|||%|||------|||---------------|-------------%-|------|||||||||--%%-------%%%------||-------------------%%%%|-%%%%-||||--|---|---------
------||||--|-||||||---r---|||---------------|-----------%%%%|------|||||||||-||---------||%%%%%-||---------------%%%%%||||--||--||||--|-------------
------||||-%|-|||||||%%%%-||||---------------|------------||-|-----||||||||||-||---------||||||--%%%%%-------------|||-||||%-||--||||-%%%%%%--XXXXXXX
------|||||||-||||||||||||||||----------------------------||-|-----||||||||||-||---------||||||--||-|--------------|||-||||--||--||||--|||----XXXXXXX