-----------------------------------------------------------------------------------------------------------------------------------------------------
-----------------------------------------------------------------------------------------------------------------------------------------------------
-----------------------------------------------------------------------------------------------------------------------------------------------------
-----------------------------------------------------------------------------------------------------------------------------------------------------
-----------------------------------------------------------------------------------------------------------------------------------------------------
-----------------------------------------------------------------------------------------------o-------------------------o---------------------------
---------------%%%--------------------%%%%%S------------------------%%%-----------------------------------------%%%%----%%%%-------------------------
----------------|----------o---------o-|||---------SSS---------------|-----------------SSSSS---------------------||------||------o-------------------
------%%%%%-----|---------%%%-------%%%|||---------------------------|-------------------------------------------||------||-%%%%%%%%-----------------
-------|-|------|----------|---------|-|||---SSS---------------------|--SSSS------------------SS---o---------o---||--o---||--||--||------------------
-------|-|%%%%-------------|---------|||||---------------------------|------------------------------%%%----------|---%%%%%|%-||--||------------------
-------|-|||||%%%%%%%%%%%%%%%--------|||||-----------%%--------------|------------------%%%%%%-------|----%%%%%--|---|||-||--||--||------------------
-------%%%%%||||||||||||||||---------|||||-----------|------------%%%%%------------------||||--------|-----|||---|---||--||--||--||------------------
-------|||||||||||||||||||||---------|||||----%%%%%%-|-------%%------|-------------------||||--------|-----|||---||--||--||||||--|-----------------o-
XXXX---|||||||||||||||||||||---------||%%%%%---||||--|-------|-------|---------%%%%------||||--------|-----|||---||--|||-||||%%%%%%%%--%%%%%-----XXXX
XXX----|||||||||||||||||||||---------||||||----|||||-|-------|-------|----------||-------||||--------||----|-|---|---||--||||||||||||---|||------XXXX