-----------------------------------------------------------------------------------------------------------------------------------------------------
-----------------------------------------------------------------------------------------------------------------------------------------------------
-----------------------------------------------------------------------------------------------------------------------------------------------------
-----------------------------------------------------------------------------------------------------------------------------------------------------
---------------------------------------------------------------------------------------o-------------------------------------------------------------
--------------------------------------------------------------------------------------%%%------------------------------------------------------o-----
--------------------%o----------------------------------------SSS----------------------|------%%%%%%--------------------%%%---------------%%%%%%%----
-------------------||------------------SSSSS-----SSS-------------o-----S--SS-----------|---o---||--o%----SS------------|-------SS--o-------|||||-----
-------------------||------------------------%%%%------------o---%---------------------|--%%%--|---|-------------------|----------%%%------||||%-----
--------------o----||---SSSS-------------------|------------%%%--|--SS-----------------|---||--|---|---|---o-----------|-----------|-------||||------
-------------------||-----------------%%%%%%%--|-------------|---|--------------|--o---|---||%-|---|---|--%%%%---------|-----------|-------||||------
-------%%%%%%%%----||-----------%%%%%%-|-|||---|-------------|---|----------%%%-%%%%%%%%%--||--|---|---|---||--%%%%%---|-----------|-------||||------
--------|||||||-%%%%-------------|||||-|-|||---|--------%%%%%%%%-|-----------|--|||||||||%-|%%||---|---|---||%%||||%%%%%%%%%------|||------|%%%%%%%--
--------|||||||||-||---------%%%-|||||-|-|||---|---------||-|||--|-----------|--|||||||||--|||||-r-|---|-r-||-|||||-|||||||%%%%%%%|||-----||||||||---
XXXXX---|||||||||-|||%%%%-----|--|||||-%%%||---|---------||-|||--|-------%%%%%%%-||||||||--|||||-%%%%%%%%%-||-|||||-|||||||||||||||||--%%%%|||||||---
XXXX----||||||||--||-|||------||-|||||--||||---|---------||-|||--|--------||||||-|||||-||-||||||-|||---|||-||-|||||-|||||||||-|-|||||---||||||||-|---