-----------------------------------------------------------------------------------------------------------------------------------------------------
-----------------------------------------------------------------------------------------------------------------------------------------------------
-----------------------------------------------------------------------------------------------------------------------------------------------------
---------------------------------------------------------------------------------------------------------------SS------------------------------------
--------oo----------------------------------------------------------------------------------------------oo-------------------------------------------
--------%%---------------------------------------------------------------------o---------------------o--%%%%---------------------oo------------------
------o-|----------------------------------------------|--------------------------------------------%%%--||------------------------------------------
-----%%||---------SS---------o---o-SSS-----------------|-----RSSS------------------------------------|---||--SSS-------------SS----------------------
------|||-----------------------%----------------------|---------------------------------------------|---|-------------------------------------------
------|||---SS--------------------------SS-------SSS---|-----|---------------o-------%---S-----------|-SS|---------------------------SS--------o-----
------|||-----------------%%%%-------------------------|-----|------------------oo---|-----------%-|||----------------------------%%%----------------
------|||------------------|||-------------------------|-----|-----%%%%-----%%%%%%%%-|-------------|||------------%%%--------%%%%%||------%%%%%%-----
------||%%-----------------|||%-----------------------%%%%%%-|------||-------||-|||--|------------|||--------------|----%%%%%|||||||-------|||||-----
---%%-||||-------------%%--|||-o-----------------------||||%-|------||-------||-|||--|-------------||--------------|-----|||-|||||||---%%%-|||||---o-
------|||---------XX--X|---|||-------------------------||-|--|------||-------||-|||--|-----XXXXX--|||--------------|%%%%-||||||||||||---||-|||||-X-%%
------|||----------X--||--||||-------------------------||-|--|-------|-------||-|||---------X--X--|||--------------||||--||||||||||||---||-|||||-----