--------------------------------------------------------------------------------------------------------------------------------------------------------------------------------
--------------------------------------------------------------------------------------------------------------------------------------------------------------------------------
--------------------------------------------------------------------------------------------------------------------------------------------------------------------------------
--------------------------------------------------------------------------------------------------------------------------------------------------------------------------------
--------------------------------------------------------------------------------------------------------------------------------------------------------------------------------
----------------------------------------------------------U-----------------------------------------------------------------------------------------------------------K---------
--------------------------------------------------------------------------------S-----------------------------------------------------------------------------------------------
--------------------------------------------------------------------------------------------------------------------------------------------------------K-----------------------
-----------------------------------------------------------------------------------------------------------------------------------------------------SSSSS----------------------
-----------------------------------------------------------------------------------------------------------------------------------------------------------------#--------------
---------S---------------------QQQ------------------------S#---------------S-------------------------------------------Q----------------------------------------##--------------
-------------------------------------*---------------T---------*-------*--------------------TT-----------------------------*-------------------TT------K-------###--------------
-----*------TT---TT------------------*-----------T-------------*-------*--------------------TT---------*------TT-----*-----*----TT-------*------T-------------####-----*--------
-----*------TT---TT--------------------------------------------*-------*---------------*----TT---------*------TT-----*-----*----TT-------*------T------------#####-----*--------
XXXXXXXXXX--XX--XXXXXXXXXXXXXXXXXXXXXXXXXXXX-------XXXXXXXXXXXXXXXXXXXXXXXXXXXXXXXXXXXXXXXXXXXXXXXXXXXXXXXXXXXXXXXXXXXXXXXXXXXXXXXXXXXXXXXXXXXXXXXXXXXXXXXXXXXXXXXXXXXXXXXXXX-XX
XXXXXXXXXX--XX--XXXXXXXXXXXXXXXXXXXXXXXXXXXX-------XXXXXXXXXXXXXXXXXXXXXXXXXXXXXXXXXXXXXXXXXXXXXXXXXXXXXXXXXXXXXXXXXXXXXXXXXXXXXXXXXXXXXXXXXXXXXXXXXXXXXXXXXXXXXXXXXXXXXXXXX--XX