--------------------------------------------------------------------------------------------------------------------------------------------------------------------------------
--------------------------------------------------------------------------------------------------------------------------------------------------------------------------------
--------------------------------------------------------------------------------------------------------------------------------------------------------------------------------
--------------------------------------------------------------------------------------------------------------------------------------------------------------------------------
--------------------------------------------------------------------------------------------------------------------------------------------------------------------------------
--------------------------------------------------------------------------------------------------------------------------------------------------------------------------------
----------------------------------------------------------------------S#--S-----------------------------------------------------------------------------------------------------
-------------------------------------------------------------------------------------------##-------------------------------------------------------K----------K----------------
--------------------------------SS--------------------------------------------------------###-----------------------------------------------------SSSS--------------------------
-----------------------------------------------------------------------#-----------------####-----------------------------------------------------------------------------------
---------------------------------------------------------SSS-----------#----------------#####------------------------------------------------------------#----------------------
------TT---------------K---*-------------T---------------------*-------#-------*------######-------K---*-------------*--------TT-------------------------#---------------*------
------TT-----------T-------*-------*-----TT---------T----------*-------#-------*-----#######-----------*---*---------*--------TT-------------------------#-----*---------*------
------TT-----------T-------B-------*-----TT-------------------##-------#--------TT--########-----------B---*---------*--------TT-------#------------#----#-----*---*-----*------
XXXXXXXXXX--------XXXXXXXXXXXXXXXXXXXXXXXXXXXXXX------XXXXXXXXXXXXXXXXXXXXXXXXXXXXXXXXXXXXXXXXXXXXXXXXXXXXXXXXXXXXXXXXXXXX----XXXXXXXXXXXXXXXXXXXXXXXXXXXXXXXXXXXXXXXXXXXXXXXXXX
XXXXXXXXXX--------XXXXXXXXXXXXXXXXXXXXXXXXXXXXXX------XXXXXXXXXXXXXXXXXXXXXXXXXXXXXXXXXXXXXXXXXXXXXXXXXXXXXXXXXXXXXXXXXXXX#---XXXXXXXXXXXXXXXXXXXXXXXXXXXXXXXXXXXXXXXXXXXXXXXXXX