--------------------------------------------------------------------------------------------------------------------------------------------------------------------------------
--------------------------------------------------------------------------------------------------------------------------------------------------------------------------------
--------------------------------------------------------------------------------------------------------------------------------------------------------------------------------
--------------------------------------------------------------------------------------------------------------------------------------------------------------------------------
--------------------------------------------------------------------------------------------------------------------------------------------------------------------------------
--------------------------------------------------------------------------------------------------------------------------------------------------------------------------------
------------------------------------------------------------------------------------------SS-SSS----------------------S---------------------------------------------------------
--------------------------------------------------------------------------------------------------------------------------------------------------------------------------------
------------#---------------------------------------------------------------------------------------------------#----------------------------------------#--------SSSSSS--------
-----------##-----------------------------------------------------------K--------------------*---------------------------------------------------------#-#----------------------
----------###-----------------------------------------------------------S--------------------#CS-------------#----------------------------------------####--SS------------------
-------*-####----*---*------------------------------T----T----------------K---------------------------TT-----#---#-----------T------TT----------------#--#----------------------
-------######----*---*-------*---------*-----------TT----T----------------------------T----------*----TT----#----#-------*----TT----TT-------*-------#####----------------------
------#######----B---*-------*---------*------------T----T---------*-----------*------TT---------*----TT----#----#-------*----TT----TT-------*------######----------------------
XXXXXXXXXXXXXXXXXXXXXXXXXXXXXXXXX---XXXXXXXXXXXXXXXXXXXXXXXXXXXXXXXXXXXXXXXXXXXXXX---XXXXXXXXXXXXXXXXXXXXXXXXXXXXXXXXXXXXXXXXXXXXXXXXXXXXXXXXXXXXXXXXXXXXXXXXXXXXXXXXXXXXXXXXXXX
XXXXXXXXXXXXXXXXXXXXXXXXXXXXXXXXX---XXXXXXXXXXXXXXXXXXXXXXXXXXXXXXXXXXXXXXXXXXXXXX---XXXXXXXXXXXXXXXXXXXXXXXXXXXXXXXXXXXXXXXXXXXXXXXXXXXXXXXXXXXXXXXXXXXXXXXXXXXXXXXXXXXXXXXXXXX