--------------------------------------------------------------------------------------------------------------------------------------------------------------------------------
--------------------------------------------------------------------------------------------------------------------------------------------------------------------------------
--------------------------------------------------------------------------------------------------------------------------------------------------------------------------------
--------------------------------------------------------------------------------------------------------------------------------------------------------------------------------
--------------------------------------------------------------------------------------------------------------------------------------------------------------------------------
--------------------------------------------------------------------------------------------------------------------------------------------------------------------------------
------------------------------------------S---------------SS------------------------------------------------------SS------------------------------------------------------------
--------------------------------------------------------------------------------------------------------------------------------------------------------------------------------
--------------------------------------------------------------------------------------------------------------------------------------------------------------------------------
---------#--------k----------------------------------------*--------------------------------------------------------------------------------------------#-----------------------
--------###-----------------------------SSSS--------------S#CS-----------------------------SSSSS--------------------------------------------------------##----------------------
-------####-----#--------K---*-----------------*------TT------------------------------------------------TT---------------------------------------------###---*-----*------------
------#####----#-------------*---TTT-----------*------TT-----------------*----TT----TT------------------TT-----------TT----TT------*------TT-----#----####---*-----*-------*----
-----######---###-#----------B---TT------------*------TT-k---------------*----TT-----T------------------TT-----------TT----T-------*------T----T-#---#####---------B-------*----
XXXXXXXXXXXXXXXXXXXXXXXXXXXXXXXXXXXXXXXXXXXXXXXXXXXXXXXXXXXXXXXXXXXXXXXXXXXXXXXXXXXXXXXXXXXXXXXXXXXXXXXXXXXXXXXXXXXXXXXXXXXXXXXXXXXXXX--------XXXXXXXXXXXXXXXXXXXXXXXXXXXXXXXXXX
XXXXXXXXXXXXXXXXXXXXXXXXXXXXXXXXXXXXXXXXXXXXXXXXXXXXXXXXXXXXXXXXXXXXXXXXXXXXXXXXXXXXXXXXXXXXXXXXXXXXXXXXXXXXXXXXXXXXXXXXXXXXXXXXXXXXXX--------XXXXXXXXXXXXXXXXXXXXXXXXXXXXXXXXXX