--------------------------------------------------------------------------------------------------------------------------------------------------------------------------------
--------------------------------------------------------------------------------------------------------------------------------------------------------------------------------
--------------------------------------------------------------------------------------------------------------------------------------------------------------------------------
--------------------------------------------------------------------------------------------------------------------------------------------------------------------------------
--------------------------------------------------------------------------------------------------------------------------------------------------------------------------------
--------------------------------------------------------------------------------------------------------------------------------------------------------------------------------
------------------------SS------------------------------------------------------------------------------------------------------SSS-------------------SS------------------------
--------------------------------------------------------------------------------------------------------------------------------------------------------------------------------
---------------------------------------------------------------------#---#------------------------------------------------------------------------------------------------------
--------##----------------------------------------------------------##--##------------------------------------------------------------------------------------------------------
-------###---------------------------------------------------------###-###--------------------------QQ--------------------------------------------------SSQ---------------------
------####------TT------------------------------TT----------------########---#------------TT-----------------*------------------TT---------*-------------------*----------TT----
----######---*---T---------------*------TT------TT-------*------##########---#-------*----TT-----*-------*---------*-------*----TT---------*--------T----------*----------TT----
---#######---*---T---------------*------TT------TT-------*-----###########-----------*----TT-----*-------*---------B-------*----TT-k--#----*--------T----------*----------TT----
XXXXXXXXXXXXXXXXXXXXXXXXXXXXXXXXXXXX---XXXXXXXXXXXXXXXXXXXXXXXXXXXXXXXXXXXXXXXXXXXXXXXXXXXXXXXXXXXXXXXXXXXXXXXXXXXXXXXXXXXXXXXXXXXXXXXXXXXXXXX----XXXXXXXXXXXXXXXXXXXXXXXXXXXXXX
XXXXXXXXXXXXXXXXXXXXXXXXXXXXXXXXXXXX---XXXXXXXXXXXXXXXXXXXXXXXXXXXXXXXXXXXXXXXXXXXXXXXXXXXXXXXXXXXXXXXXXXXXXXXXXXXXXXXXXXXXXXXXXXXXXXXXXXXXXXX-----XXXXXXXXXXXXXXXXXXXXXXXXXXXXX