--------------------------------------------------------------------------------------------------------------------------------------------------------------------------------
--------------------------------------------------------------------------------------------------------------------------------------------------------------------------------
--------------------------------------------------------------------------------------------------------------------------------------------------------------------------------
----------------------------------------------------------------------------------------------------U---------------------------------------------------------------------------
-------------------------------------------------------------------------------------------------------------------------------------------------#------------------------------
--------------------------------------------------------------------------------------------------------------##------------------------#-------##k-----------------------------
--------------------SSS-SS-----------------------------------------------------------------------------------###--------------------######-----#####----------------------------
------------------------------------------------------------------------------------------------------------####--------------------######---#######----------------------------
-----------------------------------------------------------------------------------------------------------#####--------------------#####----#######----------------------------
-------------------*--------------------------------------------------------------------------------------######-------------------#####----########----------------------------
------------------S#CS------SS--------------------------SS--------------Q-------SSSS---------------------#######------------------########-########-----------------------------
-------------------------------------------------------------*-------------------------*----------------########--------TT-------#######---########------------------K---*------
-----------------------*------------TT-------*----TT---------*---------------*---------*------TT-------#########---*----TT------########--########-------*-------T-------*------
-----------------------*------------TT-------*----TT---------#---------------*-----------*----TT------##########---*----TT-----###################-------*-------T-------B------
XXXXXXXXXXXXXXXXXXXXXXXXXXXXXXXXXXXXXXXXXXXXXXXXXXXXXXXXXXXXXXXXXXXXXXXXXXXXXXXXXXXXXXXXXXXXXXXXXXXXXXXXXXXXXXXXXXXXXXXXXXXXXXXXXXXXXXXXXXXXXXXXXXXXXXXXXXXXXXXXXXXXXXXXXXXXXXXX
XXXXXXXXXXXXXXXXXXXXXXXXXXXXXXXXXXXXXXXXXXXXXXXXXXXXXXXXXXXXXXXXXXXXXXXXXXXXXXXXXXXXXXXXXXXXXXXXXXXXXXXXXXXXXXXXXXXXXXXXXXXXXXXXXXXXXXXXXXXXXXXXXXXXXXXXXXXXXXXXXXXXXXXXXXXXXXXX