--------------------------------------------------------------------------------------------------------------------------------------------------------------------------------
--------------------------------------------------------------------------------------------------------------------------------------------------------------------------------
--------------------------------------------------------------------------------------------------------------------------------------------------------------------------------
--------------------------------------------------------------------------------------------------------------------------------------------------------------------------------
---------------------------------------------------------------------------------------------------------------------------------------------------------------------------#----
---------------K----------------------------------------------K--------------------------------------------------------------K---------------------------------------------#----
------SS------SS---*-----------------------------------S--SSSSSS----------------------------------------------------------------------------------------------------------S#----
-------------------B-------------------------------------------------------------------------------------------------------------------------------------------------------#----
-----------------------------------------------------------------------------------------------S---------------------------------------------------------------------------#----
---------------------------------------------------------------#---------##----------------------------------------------------------------------------------------------###----
-------SS----#S--S------------------QQ-------------------------#--------###---------------------------------------------------------SS------QQ--------------QQ----------###-----
------------##-----*------------TT-------*-----*-------K----#----------####--------------------------*-------T-------*--------------------------TT---------------------####-----
-----------###------------------TT-------*-----*------------#---------#####----*-------*-------------*------##-------*---------*----------------TT-------*-------------####-----
----------####------------------TT-------*-----B------------#--------######----*-------*-------------*-----###-----------------*----------------TT-------*------------#####-----
XXXXXXXXXXXXXXXXXXXXXXXXXXXXXX--XXXXXXXXXXXXXXXXXXXXXXXXXXXXXXXXXXXXXXXXXXXXXXXXXXXXXXXXXXXXXXXXXXXXXXXXXXXXXXXXXXXXXXXXXXXXXXXXXXXXXXXXXXXXXXXXXXXXXXXXXXXXXXXXXXXXXXXXXXXXXXXX
XXXXXXXXXXXXXXXXXXXXXXXXXXXXXX--XXXXXXXXXXXXXXXXXXXXXXXXXX-XXXXXXXXXXXXXXXXXXXXXXXXXXXXXXXXXXXXXXXXXXXXXXXXXXXXXXXXXXXXXXXXXXXXXXXXXXXXXXXXXXXXXXXXXXXXXXXXXXXXXXXXXXXXXXXXXXXX-