--------------------------------------------------------------------------------------------------------------------------------------------------------------------------------
--------------------------------------------------------------------------------------------------------------------------------------------------------------------------------
--------------------------------------------------------------------------------------------------------------------------------------------------------------------------------
--------------------------------------------------------------------------------------------------------------------------U-----------------------------------------------------
--------------------------------------------------------------------------------------------------------------------------------------------------------------------------------
------------------------------K-------------------------------------------------------------------------------------------------------------------------------------------------
-----------------------------SSS-------------------------------------------#----------------------------------------------------S-----------------------------------------------
--------------------------------------------------------------------------##--------U----------------------------------------------------------------------------------K--------
-------------------*------------------------------------------------------##---------------#--------------------------------------------------------------------------SS--------
-------------------*---------K-------------------------------------------###--------------##--------------------------------------------------------------------------------#---
-----------------SS#CS------SSSS-------------S---------------------------###-------------###---------------------------------------------#----------------------QQQQQ------###--
--------TT---*---------------------*----TT-----------*------------------####------------####---*-----*------TT--------------------------#------T--------------------------####--
--------TT---*---------*-----------*----TT-----------*-----------------#####----------######---*-----*------TT---------------*---------#TT-----*---*---------*-----------#####--
--------TT---B---------*-----------B----TT-----------B----------------######---------#######---B-----*------TT---------------*-----T----TT-----*---*---------*----------######--
XXXXXXXXXXXXXXXXXXXXXXXXXXXXXXXXXXXXXXXXXXXXXXXXXXXXXXXXXXXXXXXXXXXXXXXXXXXXXXXXXXXXXXXXXXXXXXXXXXXXXXXXXXXXXXXXXXXXXXXXXXXXXXXXXXXXXXXXXXXXXXXXXXXXXXXXXXXXXXXXXXXXXXXXXXXXXXXX
XXXXXXXXXXXXXXXXXXXXXXXXXXXXXXXXXXXXXXXXXXXXXXXXXXXXXXXXXXXXXXXXXXXXXXXXXXXXXXXXXXXXXXXXXXXXXXXXXXXXXXXXXXXXXXXXXXXXXXXXXXXXXXXXXXXXXXXXXXXXXXXXXXXXXXXXXXXXXXXXXXXXXXXXXXXXXXXX