--------------------------------------------------------------------------------------------------------------------------------------------------------------------------------
--------------------------------------------------------------------------------------------------------------------------------------------------------------------------------
--------------------------------------------------------------------------------------------------------------------------------------------------------------------------------
--------------------------------------------------------------------------------------------------------------------------------------------------------------------------------
--------------------------------------------------------------------------------------------------------------------------------------------------------------------------------
--------------------------------------------------##--------------------------U-------------------------------------------------------------------------------------------------
------------SSSS-------------------------SS------###-----------------------------------S--------------------------------------SS----------------------------------------SS------
------------------------------------------------####----------------------------------------------------------------------------------------------------------------------------
----##------------SS------------------S--------#####-------------------------------------------*----------------------SS-----#--------------------------------------------------
----##----------------------------------------######---------------------------*---------------*----------------------------##--------------------------------------------------
---###-----SSSSS-----------------------------#######--------QQ---------------SS#CS------------S#CS-------------------------#-#------------------------------SSSS---S------------
--####-------------K---*-----*--------------########----------------------------------------------------------------------####-------*------------------------------------------
-#####-----------------*-------------------#########-------------*---*----TT----TT-----------*-----*-------T-*---*-------#####-------*------T----------------------------*------
-#####-----------------B------------------##########------TT-----*---*----TT----TT-----------*-----*------TT-*---*------######-------*------T----------------------------*------
XXXXXXXXXXXXXXXXXXXXXXXXXXXXXXXXXXXXXXXXXXXXXXXXXXXXXXXXXXXXXXXXXXXXXXXXXXXXXXXXXXXXXXXXXXXXXXXXXXXXXXXXXXXXXXXXXXXXXXXXXXXXXXXXXXXXXXXXXXXXXXXXXXXXXXXXXXXXXXXXXXXXXXXXXXXXXXXX
XXXXXXXXXXXXXXXXXXXXXXXXXXXXXXXXXXXXXXXXXXXXXXXXXXXXXXXXXXXXXXXXXXXXXXXXXXXXXXXXXXXXXXXXXXXXXXXXXXXXXXXXXXXXXXXXXXXXXXXXXXXXXXXXXXXXXXXXXXXXXXXXXXXXXXXXXXXXXXXXXXXXXXXXXXXXXXXX