--------------------------------------------------------------------------------------------------------------------------------------------------------------------------------
--------------------------------------------------------------------------------------------------------------------------------------------------------------------------------
--------------------------------------------------------------------------------------------------------------------------------------------------------------------------------
--------------------------------------------------------------------------------------------------------------------------------------------------------------------------------
--------------------------------------------------------------------------------------------------------------------------------------------------------------------------------
--------------------K-----------------------------------------------------------------------------------------------------------------------------------------------------------
----------------------------SS------------------------------------------------------------------------SSSS--------------------SSS--------------------#-------SSSSS--------------
---------------------------------------------------------------------------------------------------------------------------------------#------------##--------------------------
-------------------------------------------------#------------------------------------------------------------------------------------##-----------###--------------------------
-------------------------------------------------#----------------------------------------------------------K--------------------------##---------####-------K------------------
-----------------------------SS--S--------------##-----------------------------------------------------SSSSSSS-----------------------####--------#####-----SSSSSSS--------------
-------------*-------------*-----------*-------###--------------TT-----K------------TT-----*-------------------------K---*----T-----#####-------######--------------------------
-------------*------TT-----*-----*-----*------####--------------TT-------------T----TT-----*-------TT--------------------*----T----######------#######-----------------*--------
-------------*------TT-----B-----*-----*-----######-------------TT------------TT----TT-----*--------T--------------------*----T-----####------########-----------------*--------
XXXXXXXXXXXXXXXXXXXXXXXXXXXXXXXXXXXXXXXXXXXXXXXXXXXXXXXXXXXXXXXXXXXXXXXXXXXXXXXXXXXXXXXXXXXXXXXXXXXXXXXXXXXXXXXXXXXXXXXXXXXXXXXXXXXXXXXXXXXXXXXXXXXXXXXXXXXXXXXXXXXXXXXXXX------
XXXXXXXXXXXXXXXXXXXXXXXXXXXXXXXXXXXXXXXXXXXXXXXXXXXXXXXXXXXXXXXXXXXXXXXXXXXXXXXXXXXXXXXXXXXXXXXXXXXXXXXXXXXXXXXXXXXXXXXXXXXXXXXXXXXXXXXXXXXXXXXXXXXXXXXXXXXXXXXXXXXXXXXXXX------