--------------------------------------------------------------------------------------------------------------------------------------------------------------------------------
--------------------------------------------------------------------------------------------------------------------------------------------------------------------------------
--------------------------------------------------------------------------------------------------------------------------------------------------------------------------------
-----------------------------------------------S----------------------------!-------------#-##----S---!S------------------------------------------------------------------------
------------S!S!--------------------------------------------------------------------!-----###-----------------------------------------S1----------------------#-#---------------
------------------------#-----------S-------S--------------------!--------@-----------------S---------------------------SS!-----1---1--------------------S----#-----------------
-------------S-----------------------------------------------------------------------------SSS---!-----------------------!-@----S-----#-------------!--------S------------------
-------------!-----------------------------------------------#--!----------------------------------------------------SS----------------!---------S!-----------------------------
---------------------SS-1-------------S----S-----------------#-----------!-----------------------------------------------------------!----------SS-------------S----------------
--!--!---------##--1----!----------#-------SS-------------#-#-----------------------------------!------------------------------------SS!!--------------------------------S------
---------------#--------------------S-----SS---------S-----#-----S!--------------------------------------------#----------------------------------------------------------------
--------SS------#------g-----@--------------------------##-#--------------------------------S-----------------##SSS-------------------------------------------S-----------------
----------g-------------@------#---S!---------------S----1--------------------------S------------S!-!---------------------------------------------S1----------------------------
--------S--!-!--##--S------C-####--U---!!-------#-----t--#-------tt---U--!--tt!---###----!----------t-----------@----t-#--U--!-----!------t-S--t###-----!---!---!#--t--##-------
--------g----k-####--------g#####-----g-------####t-ttt-#------ggtt---t----g-t-----##--------gg---ggtt-S----tt-----gg##XX---g--t-----g#--#k---gtt##------------k--g-tt-##t------
XXXXXXXXXXXXXXXXXXXXXXXXXXXXXXXXXXXXXXXXXXXXXXXXXXXXXXXXXXXXXXXXXXXXXXXXXXXXXXXXXXXXXXXXXXXXXXXXXXXXXXXXXXXXXXXXXXXXXXXXXXXXXXXXXXXXXXXXXXXXXXXXXXXXXXXXXXXXXXXXXXXXXXXXXXXXXXX-