--------------------------------------------------------------------------------------------------
--------------------------------------------------------------------------------------------------
--------------------------------------------------------------------------------------------------
--------------------------------------------------------------------------------------------------
--------------------------------------------------------------------------------------------------
--------------------------------------------------------------------------------------------------
--------------------------------------------------------SS---------!------------------------------
--------------------------------------------------------------------------------------------------
-------------------!------------------!-------------------------------SSSSS--!--------------------
--------------------------------------------------------------------------------------------------
------S-------S!---------##-----------------t-----------SS---------!------------------------------
--------------------------#--##---------#--#---------------------------------------------#--------
-------------------------tt--##------#--#--##---------------------------------------t----##-------
--------------------g----tt-###-----#---#---##------gg----------------g-------------t-----##------
---XXXXXXXXXXXXXXXXXXXXXXXXXXXXXXXXXXX-XXXXXXXXXXXXXXXXXXXXXXXX--XXXXXXXXXXXXXXXXXXXXXXXXXXXXXXXXX
---XXXXXXXXXXXXXXXXXXXXXXXXXXXXXXXXXXX-XXXXXXXXXXXXXXXXXXXXXXXX--XXXXXXXXXXXXXXXXXXXXXXXXXXXXXXXXX