---------------------------------------------------------------------------------------------------------------------------------------------------------------------
---------------------------------------------------------------------------------------------------------------------------------------------------------------------
---------------------------------------------------------------------------------------------------------------------------------------------------------------------
---------------------------------------------------------------------------------------------------------------------------------------------------------------------
---------------------------------------------------------------------------------------------------------------------------------------------------------------------
------SS----------------------------------------oooooo---------------------------------------------------------------------------------------------------------------
--SS-------SSS------------SSSSS-S---------------SS--------------------%%--SS----------------%%%%---------------SSS-------%SS---------------------------------SS------
--------------------------------------------------------oooo----------|----------------------||----------------------------------------------------------------------
--------S--------------Soo-------------------------------------------|-----------------------||----------------------SS--|-------------------------------------------
---------------------------------------------------------------------|-----------------------||--------------------------|-------------------------------------------
--------------%%%%%%%---SS-----%%%%SS---------%%%-------%%%%---------|------%%%--------SSS---||---%%%-SS--%%%-----%%-----|-----%%%%%-S------%%%%%%----%%%%%----------
-------%%------|||||------------||-------------|---------|-----------|-------|-------|-------||----|-------|-------||%---|------|||----------||||------|||-----------
-------|||-----|||||------------||-------------|---------|-------------------|-------%%%-----||-%%%|-------|-------||----|------|||----------|||---%----||---------X-
-------|||-----|||||------------||-------------|---------|-------------------|-------||------||--|||-------|-------||----|------|||----------|||--|-----||---------X-
-------|||-----||||%%%%------%%%||--%XXXXXXX--%%%%---%%%%|--%---%XXXXXXXXXXXXXXXXXXX%||%-----||--|||---%%%%%%%%%---||-%-%|%%%%%%|||%%%%%%----|||-|||--%|||------XXXXX
-------|||-%---||||-||---------|||---XXXXXXX---||-----||-|-------|XXXXXXXXXXXXXXXX---||------||--|||-----|-|-||----||----|--||-||||-||%||----|||-||-----||-------XXXX