---------------------------------------------------------------------------------------------------------------------------------------------------------------------
---------------------------------------------------------------------------------------------------------------------------------------------------------------------
---------------------------------------------------------------------------------------------------------------------------------------------------------------------
------oo-------------------------------------------------------------------------------------------------------------------------------------------------------------
---------------------------------------------------------------------------------------------------------------------------------------------------------------------
---------------------------------------------------------------------------------------------------oooo--------------------------------------------------------------
------SSoo--SS%%----------SS---S---------SSS-------------------------SSSSooooo--%%%%-------SSS----------------------------------------SSS------------------SS--------
----------------------------------------------------------------------------SS---||----------------------------------------------------------------------------------
--------------|--------SS---------SS---------------------------------------------||------------------SSSoo-----------------------------|---------SSS-----------------
-------------------------------------------SS------------------------------------||---oo-----------------------------------------------||-------------------S--------
------------SS|-----------%%%%%----------------S-------------------------S----SS-||-------%%%--S--------%---%%%%%%---------S-----------||%%%SS-----------------------
---------------|-----------|||-----------------------------------------SSS-------||--------||-----------%||%||-------------------------||||--------------------------
--------------%|%%%%%%-----|||---------------------------------------------------||--------||------------||-||--|----------------------||||--------------------------
---------------|-||||------|||---------|-----------------------------------------|||-------||------------||-||--|----------------------||||------------------------X-
-%%%%%%--------|-||||------|||---------%%%%---%%%%%%%%%%----%%%%%-%%%%-----------|||-------||%-%%%%%--%%%||%|%%%%%XXXXXXXXXXXXX--%%%%%%%|||-XXXXXXXXX%%%%%%------X|-X
X--|||---------|-||||------|||---------|||-----||||||||------|||---||------------|||-------||-|--||---||-||-|--||-XXXXXXXXXXXXX---||||---||-XXXXXXXX--||||--------|-|