---------------------------------------------------------------------------------------------------------------------------------------------------------------------
---------------------------------------------------------------------------------------------------------------------------------------------------------------------
---------------------------------------------------------------------------------------------------------------------------------------------------------------------
-----------------------------------------------------------------------------------------------------------------------------------------oo--------------------------
---------------------------------%%%%------------------------------------------------------ooo-----------------------------------------------------------------------
----------------------------------||--------------------------------------------------oooooo-----------------oo-----------------------------ooo----------------------
------SSS-------------------------||-----------SSS----------------------SS-------SSSS--------%%S---------------------------------------SSSSS-----------------SS------
----------------------------------||---------------------------------------------------------------------------------------------------------------------------------
--------------S---------SS--------||----SS----------S-------SS------------oo---------------SSS-------------------------------SSS-------------------------------------
-----------------------------------|-----------------------------------ooo-----------------SSS-----------------------------------------------------------------------
-----------------------------%----%%%---%%%%--------------%%%-------%%%-----SS----------------------------------SS---------------------SS---------------%%%%---------
------------------------%%%%||-----|-----||---------------||---------|-----------------------------------------------------------------------------------||----------
-------------------------|||||-----|-----||---------------||---------|------------------%%%-----------------------------------------------------%%%------||%%%%------
-------------------------|||||-----|-----||---------------||---------|-------------------|-------------------------------------------------------|-------|||||-------
---XXXXXXXXXXXXXXXXXXX%--|||||----%X%-%%%||%%%%-------%%%%||%%%%%---%|%%%%---------------|----XXXXXX%%%%%%%%%%%%%--%%%%%%%%----%%%%%-------------|%%%----|||||-------
----XXXXXXXXXXXXXXX--%---|||||-----|-----||-----------|||-||-|||-----|--|----------------|----XXXX---||||||--||||----|||||------|||--------------|||-----||||||------