---------------------------------------------------------------------------------------------------------------------------------------------------------------------
---------------------------------------------------------------------------------------------------------------------------------------------------------------------
---------------------------------------------------------------------------------------------------------------------------------------------------------------------
--------------------ooo----------------------------------------------------------------------------------------o-----------------------------------------------------
------------------%%%------------------------------------------------------------------------------------------------------------------------------------------------
-------------------|-----------ooo-----------------------------------------o-----------------------------------------------------------------------------------------
----------SS-------|------SSS--------------SSS------SS--------------------------------SSS---------------------SS-----S---------------------SS-----SS-----------------
-------------------|-------------------------------------------------------------------------------------------------------------------------------------------------
--------------SS---|------------SSS-------------------------SS---------------------------------------------S-----------------------------------------SS----o---------
-------------------|----oo---------------------------------------------------------------------------------------%%|%------------------------------------------------
-------------------SSSS---------------%%----------SS----SS------%%%%%-------%%%-------%%%%------------------------||-------------------------%%%%%---------%%%%------
---------------------------------------|-------------------------|||---------|---------||-------------------------||-------------------------||||----SSSS---||-------
----------------------%%%%%%----------|||------------------------|||---------|---------||------------------------|||-------------------------||||-----------||-------
-----------------------||||-----------|||------------------------|||---------|---------||------------------------|||-------------------------||||-----------||-------
XXXXXXX-%%%%%----------||||%%%%-%%%%--|||%%%%---%%%%%------------|||-%%%%----|%%%%%-%%%||------%%%%--%%%%%%%%%---|||-%%%%%XXXXXXXXXXXXX--%%%%||||%%%--------||-------
XXXXXXX--|||-----------|||||||---||---||||||-----|||-------------|||-|||-----|-|||---|-||-------||----||-||%|%---|||--|||--XXXXXXXXXXX----||-||||-|---------||-------