---------------------------------------------------------------------------------------------------------------------------------------------------------------------
---------------------------------------------------------------------------------------------------------------------------------------------------------------------
---------------------------------------------------------------------------------------------------------------------------------------------------------------------
---------------------------------------------------------------------------------------------------------------------------------------------------------------------
---------------------------o----------------o------------o--------------------------------------------------------oo-------------------------------------------------
-------------------------------------------oo------------%--------------------------------------------------------%-----------------Soooo----------------------oooSS-
-------SSS------------------------------------------------------------------------SS----------------------------------oooo----SSS---------------S----S%%%%%%---------
------------------------------------oo-----------------------------------------------------------------------oo---------oo-----------|------------------|||----------
------------SS-----------------------------SSS--%%%------SSS--------SS---------------------SSSS--------------------------------------|---------S--------|||----------
---------------------------SSS-------------------|-----------------------------------------------------------------SS----------------|------------------|||----------
----SS----------------%%%%-------S------------%--||---------%%%%---------------------SSS-----------%%-%%%%%%%-SS-------SS|-%%%%---%%%%--%%%%%-----------||%%%%%------
------%%%%%------------||------------------------||----------||--------------------------------SS--||--||||%%------------|--||-----||----|||------------||--||-------
------||||-------------||------------------------||----------||------------------------------------||--|||||||-----------|--||-----||----|||------------||-|||-------
------||||-------------||----------------------||||----------|||-----------------------------------||--|-|||||-----------||-||-----||----|||------------|||||||------
----%%%%|------%%%%%-%-||%%%%-----%%--%%%%-----||||%-%%%%%%%%|||--------XXXXXXXXXX%%%%%%%%---------||%%%-|||||-----------||-|||----||%%%%|||----------%%%%%||||-XX%--
-----||||-------|||----||-||------||---||------||||---|||-||-|||--------XXXXXXXXXX-|||-||----------|--||-|||||-----------||-|||----||-||-||||----------||||||||--|---