---------------------------------------------------------------------------------------------------------------------------------------------------------------------
---------------------------------------------------------------------------------------------------------------------------------------------------------------------
---------------------------------------------------------------------------------------------------------------------------------------------------------------------
---------------------------------------------------------------------------------o------------------------------------------------------------o-----------------oo---
---------------------------------------------------------------------------------------------------------------------------------------------------------------------
-------------------------oo---------------------------------------ooo----------------------------------------------oo--------------------------------oooo------------
---------------%%%%--SSS-------S--%%%------SSSoo--------------SS-----------------SSS-----------------SS-------------------o---%%%%%------------SSSS--%-----------S---
----------------||----------------||------------------------------------------------------------------------------------%%%%----|o-ooo-------------------------------
--SS------------||-------SSSSS----||-----------------------------SSS-----------------S---------------------------SS|-----------------------------------SS--SSo-------
----------------||-----------------|-------------------------------------------------S--------------------ooo------|--------------------------------|----------------
------%%------%%%|-----------------|%%%%------SS------%%%%%---------%%%%%%%-----------------%%%%%%-----SSSSS------%%%%--------S--SS--SSS---SSS---%%%|----------------
------||%%%----|||-----------------|-||---------SSS----|||-----------|-|||-----------------%-|||%------------------||----SSSS----------------------||----------------
------|||||----|||-----------------|-||----------------|||-----------|-|||-----------|-----|-||||------------------||------------|-----------------||----------------
------|||||----|||-----------------|-|||---------------||||----------|-|||-----------------|-|||-------------------||------------|---|------------|||----------------
-----%|||||%%%%|||-%%%%%--%%%%--%%%%-|||-%%%-----------||||-%-%%%%%%%|||||%%%%%%%%%%%-%%%%%%%|||%%%%---------------||%%%---------|---||-----------|||%%%%%%%%--------
------|||||-||-|||--|||----||----|---|||-||------------||||----|||||-|-||--|||||-||||--||--|-|||-||----------------||-|--------------||-----------|||-|||||||--------