---------------------------------------------------------------------------------------------------------------------------------------------------------------------
---------------------------------------------------------------------------------------------------------------------------------------------------------------------
---------------------------------------------------------------------------------------------------------------------------------------------------------------------
-----------------------------------------------------------oo--------------------------------------------------------------------------------------------------------
-------------------------------------------oo-------------------------------------------------------------------------%%%%%------------------------------------------
-----------------------------oooo--------------------------------------------ooo---------------------------------------|||-------------------------------------------
-------SSS--------------SS-----------SSS----%%%-------------SSSS-----------------------------%%%%----------------------|||--------o----------------------------------
---------------------------------------------|------------------------oo----------------------||-----------------------|||---------%oooo-----------------------------
-------------------oo---------SSS------------|-----ooo-----------------------SSS-----o--------||-------S-------------S--||-------SSS----------------ooo--o-----------
--------SSS----oooSSS------------------------|-------------------------------------------------|---------------------SS%%%-------------------------SSS---------------
--------------SS-----%%%%----------------S---|%%%%---S-S-------------SSSSSS-----%%%----S-----S-|%%----------%%%%%----------%%%%%--------SSSS----------------%%%%-----
----------------------||-----------------SS--|-||--------------------------------|-------------|-|%%%-%%%----|||-----------||||---------------------%%%%-%%%|||------
----------------------||---------------------|-||--------------------------------|-------------|-||----|||---|||-----------||||----------------------||----||||------
----------------------||---------------------|-||--------------------------------|-------------|-||----|||---|||-----------||||----------------------||----||||----X-
XXXXXXX-%%%-----------||-------%%%%%%%-----%%%%%%%%%%%%%%%%%%-%%%%-----------%%%%|%%%%%--------|-||%%%-|||---|||-----------%%|%%%%-----------|-------||----||||-XXXXX
XXXXXXX--|-------------|----------|||--------|||||||---|||||---||--------------|-|-|||-----------||-||-|||---|||-----------|-||||------------|-------||----||||-XXXXX