---------------------------------------------------------------------------------------------------------------------------------------------------------------------
---------------------------------------------------------------------------------------------------------------------------------------------------------------------
---------------------------------------------------------------------------------------------------------------------------------------------------------------------
---------------------------------------------------------------------------------------------------------------------------------------------------------------------
---------------------------------------------------------------------------------------------------------------------------------------------------------------------
-----------------------------------------------------------------------------------------------oo------------------------------------------------------oooo----------
----------------------------------SS--------------------------------%S------------SS-------------------S---------------S------------------------------SS-------------
-------|---------------------------------ooooo----------oo---------|-----------------------------------|-------------------------------------------------------------
----SS||------------------------------SSSS-------------------------|-----------------S%%-------SS----SS|-----------------o--------------------------------S----------
------||----------%%oooo-------------------------------------------|-------------------|---------------------------------------------------------------SS------------
------||----------SS-------%%%%--%%%%-------SSSS-----SSSSS-------S-|--%%%%SS-----------|------------------S-%%%%%-%S--%%%%%-%%%%%%%--SS-%%%%---S-------------S-------
------||--------------------||-----|-------------------------------|---||--------------|---------------------||--------|||---|||||-------|||%------------------------
------||--------------------||--%%||-------------------------------|---||--------------|---------------------||||%%----|||---|||||-------|||-------------------------
------||--------------------||----||----------------------------------|||--------------|---------------------|||||-----|||---|-|||-------|||-------------------------
XXXXXXXXXXXXXX%-------------||----||-------------%%%%-%%%%%%----------||--%%%%%%%%%%--%%%%%-%%%%%%%%%%%%-----|||||---%-|||---|-|||-------|||-%%%%%%%%%%%%----%%------
XXXXXXXXXXXXXX--------------||----||--------------||---|-||-----------||---|||||-||%---||----|||||||-||------|||||--||-|||---|-||||------|||---|-|||||||-----||------