---------------------------------------------------------------------------------------------------------------------------------------------------------------------
---------------------------------------------------------------------------------------------------------------------------------------------------------------------
---------------------------------------------------------------------------------------------------------------------------------------------------------------------
---------------------------------------------------------------------o-----------------------------------------------------------------------------------------------
---------------------------------------------------------------------------------------------------------------------------------------------------------------------
-----------------------ooo-------------------------------------ooo-----------------------o------------------------------------------ooSo-----------------------------
------||------------SSSS-%------SS---------SS------------S-SSS-------SSS------------%%%%-----------------------%%%%--------------------------------------------------
------||-----------------------------------|---o-------------------------------------||------------------------|||---------------------------------------------------
------||-----------------------------------|------%%%%%---------SS---------------SSS-||------S-----------------|||------------SSS--------SSSS------------------------
------||----------------------o----S-------|--------||-------------------------------||------------------------|||---------------------------------------------------
------||-%%%---------------S----------%%%%%%%-------||-----SS-------%%%--------------|%%%%%----SS-%%%----------|||------------------%%%%%--------------%-------------
-----||||||----------------------------|||||--------||---------------|---------------|||||--------%||----------||||-|----------------|||-----------------------------
-----||||||----------------------------|||||--------||---------------|---------------|-|||---------||----------||||-||---------------|||----------%%%%%--------------
-----||||||----------------------------|||||--------||---------------|---------------|-|||---------||----------|-||-||---------------|||-----------|-||------------X-
XXXXX||||||-XXXXXXXXXX%------%%%%------|||||--------||%%%%%%%%-------|XXXXXXXXXX-----|||||---------||%%--------|%|||||----%%%%XXXXX%%%||-%%%%%%%%%%|%||%%%%%%--XXXXXX
XXX--||||||-XXXXXXXX-X--------||-------|||||--------||-||-|||--------|XXXXXXXXXXX----|-|||---------|||---------|-|||||-----||-XXXX---|||--|--|||||||-||--|||---XXXXXX