---------------------------------------------------------------------------------------------------------------------------------------------------------------------
---------------------------------------------------------------------------------------------------------------------------------------------------------------------
---------------------------------------------------------------------------------------------------------------------------------------------------------------------
------------------------------------------------------------------------------------------------------------------------------------------oo-----oo--------oo--------
---------------------------------------------------------------------------------------------------------------------------------------------------------------------
----------------------------------------------------------------------------------------------oo---------------------------oooo----oo--------------------------------
--------------SS----------------------%%%%--------------------------SSS---------------------------%%%%S--------SSS--------SS--%-----------SSSS-----%%%%----SSSSS-----
---------------------------------------||---------------------oo-----------------------------------|-------------------------------------------------|---------------
-----SS--------------------------------||---------------%------------------------------------SSSS--|-------S-----------------SS-----SS--------------||---------------
-----------------------------------S---||--------------||------------------------------------------|------------------------------------------------||---------------
--------%%%%%--------%%%%%%%-----------||---SS---%%%%--||----%%-----%%%SSSSS-------%%%%%-----------|%%----------%%%%-SSS---------SS--S--------------||---------------
---------|||----------|||||------------|||--------|||--||----|-------||-------------|||------------||-|-%%%%%----||---------------------------------||---------------
---------|||----------|||||------------|||--------|||--||-%%%|-------||-------------|||------------||-|-||||-----||---------------------------------|----%%%---------
---------|||---------||||||------------|||--------|||--|--||-|-------||-------------|||------------||----|||-----||--------------------------------||-----|--------X-
XXXXXX---|||----%%%%%-|||||-%-----%%%%-|||-----%%%|||-%|%|||-|%%%%%%%%%%%-%%XXXXXXXX|||%%%%-------%|%%%%%|||--%%%||%%%%%%%%%----------------%%%----||XXXXXXX|--XXXXXX
XXXXXX---|||-----|||--|||||--------||--|||------|||||--|||||-|-||-||-||---||XXXXXX-||||-||---------||-||-|||--||-||-|||||||------------------|-----|XXXX-X|||--XXXXXX