----------------------------------------------------------------------------------------------------------------------------------------------------------------------------------------------------------------------
----------------------------------------------------------------------------------------------------------------------------------------------------------------------------------------------------------------------
----------------------------------------------------------------------------------------------------------------------------------------------------------------------------------------------------------------------
----------------------------------------------------------------------------------------------------------------------------------------------------------------------------------------------------------------------
----------------------------------------------------------------------------------------------------------------------------------------------------------------------------------------------------------------------
----------------------------------------------------------------------------------------------------------------------------------------------------------------------------------------------------------------------
-----------------------------------------------------------------#-------------------------------------------------S------------------------------------------------------------------------SSS-----------------------
--------------------------------------------------------------------------------------------------------------------------------------------------------------------------------------------------------------TT------
---------------------------------------#--------------------------------------TT------------------S-----------------------------------------------------------------------------TT----------------------------TT------
--------------------------------------##--------------------------------------TT------------------------------------------------------------------------------------------------TT----------------------------TT------
----TT------tt-------T------tt------T-##------------------------------------T-XX------------------t---------TT----------------------TT----TT--------------------------TT-T------TT-------------------S--------XX------
----TT-------t------TTT------t----TTTT##------------------------------TT---TT-------------TT------t---------TT----------------------TT----TT-------T----------TT------TT------T-TT--------------------------T---------
----TT-------tt-T---TTTT-----t----TTTT##------TT----tt--------TT---T--TT--TTT---------TT--TT--------TT--T---XT------------TT--------TT----TT-----TTT--TT------TTTT----TT------TTTT------tt-------T----------TT--------
----TT-------tt-TT--TTTT-----t----TTTT-#------TT----tt--------TT---T--TT--TTT---------TT--TT--------TT---------k----------TT----k--TT-----TT-----TTT--TT------TT----k-TT------TT--------tt-------T--------k-TT--------
XXXXXXXXXXXXXXXXXXXXXXXXXXXXXXXXXXXXXXXXXXXXXXXXXXXXXXXXXXXXXXXXXXXXXXXXXXXXXXXXXXXXXXXXXXXXXXXXXXXXXXXXXXXXXXXXXXXXXXXXXXXXXXXXXXXXXXXXXXXXXXXXXXXXXXXXXXXXXXXXXXXXXXXXXXXXXXXXXXXXXXXXXXXXXXXXXXXXXXXXXXXXXXXXXXXX--
XXXXXXXXXXXXXXXXXXXXXXXXXXXXXXXXXXXXXXXXXXXXXXXXXXXXXXXXXXXXXXXXXXXXXXXXXXXXXXXXXXXXXXXXXXXXXXXXXXXXXXXXXXXXXXXXXXXXXXXXXXXXXXXXXXXXXXXXXXXXXXXXXXXXXXXXXXXXXXXXXXXXXXXXXXXXXXXXXXXXXXXXXXXXXXXXXXXXXXXXXXXXXXXXXXXX--