----------------------------------------------------------------------------------------------------------------------------------------------------------------------------------------------------------------------
----------------------------------------------------------------------------------------------------------------------------------------------------------------------------------------------------------------------
----------------------------------------------------------------------------------------------------------------------------------------------------------------------------------------------------------------------
----------------------------------------------------------------------------------------------------------------------------------------------------------------------------------------------------------------------
-------------------------------------------------------------------------------------------------------------------------------------------###---------------------------------#--------------------------------------
-------------------------------------------------------------------------------------------------------------------------------------------###------------------##------------##--------------------------------------
------------------------SS---------------SS---------TT--TT------------SS--------------------------------TT--------------------------S-------##-----------------####-----TT---####----SS------S--S---------------------
-----#----------------------------------------------TT---------------------------------------------------T----------------------------------##----------------#####-----TT--#####-------------------------------------
---------------------------------------S------------XXS-X-----------------TT-----------------------------X---------------------------------###---S-----------######-----TT-######----------------------SS-------------
------------------------------------------------TT------------------------TT---------------------------------------------------------------###--------------#######--##-#T-#######------------------------------------
--------------TT----------TT----tt--------------TT--------------TT------TT-------tt----------S-----------SS------t----XX----------TT----------#-----------TT###########--#-######-#--------SSS----TT------------------
------TT------TT--T-------TT----tt--------------TT------------TT--------TT--------------------------------------------------------TT---------------------#TT#######-###----######-----------------TT------------------
------TT------TT--TT------------tt--------------TT------------TT--------TT--------------------------------TT----t--------------TT-TT----TT-#---#-T-------#TT###########--TTT#####-----------------TT----------TT------
------TT------TT--TT------------tt--------------TT------------TT--------TT---------------------k----------TT----t--------------TT-TT----TT-#-###-T------##TT############-TTT####------------------TT----------TT---#--
XXXXXXXXXXXXXXXXXXXXXXXXXXXXXXXXXXXXXX--------XXXXXXXX------XXXXXXXXXXXXXXXXXXXXXXXXXXXXXXXXXXXXXXXXXXXXXXXXXXXXXXXXXXXXXXX---XXXXXXXXXXXXXXXXXXXXXXXXXXXXXXXXXXXXXXXXXXXXXXXXXXXXXXXXXXXXXXXXXXXXXXXXXXXXXXXXXXXXXXXX
XXXXXXXXXXXXXXXXXXXXXXXXXXXXXXXXXXXXXX--------XXXXXXXX------XXXXXXXXXXXXXXXXXXXXXXXXXXXXXXXXXXXXXXXXXXXXXXXXXXXXXXXXXXXXXXX---XXXXXXXXXXXXXXXXXXXXXXXXXXXXXXXXXXXXXXXXXXXXXXXXXXXXXXXXXXXXXXXXXXXXXXXXXXXXXXXXXXXXXXXX