----------------------------------------------------------------------------------------------------------------------------------------------------------------------------------------------------------------------
----------------------------------------------------------------------------------------------------------------------------------------------------------------------------------------------------------------------
----------------------------------------------------------------------------------------------------------------------------------------------------------------------------------------------------------------------
----------------------------------------------------------------------------------------------------------------------------------------------------------------------------------------------------------------------
-----------------------------------------------------------------------------------------------------------------------------------------------------------S----TT----------------------------------------------------
------------------------------------------------------------------------------------------------------------------------------##--------------------------------TT----------------------------------------------------
----------------------------------------------------------------------------------SSSSSS--------------SSSSS---------SS-------###-------SS-----------------------XX--------------TT-------T---------S------SSS---------
----------------------------------------------------------------------------------------------------------------------------####-------------------------------------#----------TT------TT----------------------------
--------TT-------------------SSS------------------TT-----------------------------------------------------------SSS---------#####----SS--------SS------TT------------------------XX------XX----------------------SS----
--------TT----------------------------------------TT----------------------------------------------------------------------######----------------------TT-------#------------------------------------------------------
--------XX---S-------------------------S----------TT-----tt-----TT-----------------#--------TT---tt------S---------------T######----------TT----------XX------##-------------------------------TTT--SS----------------
------------------------------------------TT------TT-----t--TT--TT----TT----t---TT-#--------TT---tt----------------------T######----------TT----------------TT-#------------------------------TT--------------T-------
----------------TT---TT-TT----------------TT----T-TT----tt--TT--TT----TT----tt--TT-#-----T--TT---tt----------------------#######----------TT------T--------#T--##---------------TT------------TT----------------------
--------------k-TT--TTT-TT------T-------k-TT----T-TT---#tt--TT--TT----TT----tt--TT-#--------TT---t----------------------########----------TT------TT------##T--#----------------TT------------TT----------------------
XXXXXXXXXXXXXXXXXXXXXXXXXXXXXXXXXX--XXXXXXXXXXXXXXXXXXXXXXXXXXXXXXXXXXXXXXXXXXXXXXXXXXXXXXXXXXXXXXXXXXXXXXXXXXXXXXXXXXXXXXXXXXXXXXXX----XXXXXXXXXXXXXXXXXXXXXXXXXXXXXXXXXXXXXXXXXXXXXXXXXXXXX-XXXXXXXXXXXXX---XXXXXX--
XXXXXXXXXXXXXXXXXXXXXXXXXXXXXXXXXX--XXXXXXXXXXXXXXXXXXXXXXXXXXXXXXXXXXXXXXXXXXXXXXXXXXXXXXXXXXXXXXXXXXXXXXXXXXXXXXXXXXXXXXXXXXXXXXXX----XXXXXXXXXXXXXXXXXXXXXXXXXXXXXXXXXXXXXXXXXXXXXXXXXXXX--XXXXXXXXXXXXX---XXXXXX-X