----------------------------------------------------------------------------------------------------------------------------------------------------------------------------------------------------------------------
----------------------------------------------------------------------------------------------------------------------------------------------------------------------------------------------------------------------
----------------------------------------------------------------------------------------------------------------------------------------------------------------------------------------------------------------------
----------------------------------------------------------------------------------------------------------------------------------------------------------------------------------------------------------------------
----------------------------------------------------------------------------------------------------------------------------------------------------------------------------------------------------------------------
----------------------------------------------------------------------------------------------------------------------------------------------------------------------------------------------------------------------
----------------TT------------------TT-------TS------------------------------------------------------SS---------------------SS----------------------------------------------------------------S-----------------------
----------------TT------------------TT------T-------------------------------------------------------------------------------------------------------------------------------------------------------------------------
----------SS----X-----------TT------XX------T-----------------------------------------------------------------------------------------------------------------------------------------------------SSSS--------TT------
----------------------------TT--------------T--------------------------------------------------T----------------#----#----------------------------------------------------------------------------------------TT------
XS---T---X---T---S-----------T-----S--------TT----------------------T---tt-------------------------------------#----#-----------------------------------tt--T-----TT--S-S--------t----TT------------------S---TT------
----TT------TT------TT------TT--------TT----TT----------------TT----T-----------------------------------TT-#TT------------------------------------TT--------TT----TT------------tt----TT--------------TT------TT------
----TT------TT------TTT-----TT--------TT--#-TT--------TT--##T-TT----TT------------------------TTTT------TT-#TT-#TT----------------------TT------TTTT--------TT----TT------------tt--TTTT------TT------TT----T-TT------
----TT------TT------TTT-----TT--------TT-##-TT-------k-T--##--TT----TT-------k----------------TTTT----#-TT-#TT##TT--#---------TT--------TT------TTTT-----#--TT-----T------------tt--TTTT----#-TT------TT----T------#--
XXXXXXXXXXXXXXXXXXXXXXXXXXXXXXXXXXXXXXXXXXX-XXXXXXXXXXXXXXXXXXXXXXXXXXXXXXXXXXXXXXXXXXXXXXXXXXXXXXXXXXXXXXXXXXXXXXXXXXXXXXXXXXXXXXXXXXXXXXXXXXXXXXXXXXXXXXXXXXXXXXXXXXXXXXXXXXXXXXXXXXXXXXXXXXXXXXXXXXXXXXXXXXXXXXXXXX
XXXXXXXXXXXXXXXXXXXXXXXXXXXXXXXXXXXXXXXXXXX-XXXXXXXXXXXXXXXXXXXXXXXXXXXXXXXXXXXXXXXXXXXXXXXXXXXXXXXXXXXXXXXXXXXXXXXXXXXXXXXXXXXXXXXXXXXXXXXXXXXXXXXXXXXXXXXXXXXXXXXXXXXXXXXXXXXXXXXXXXXXXXXXXXXXXXXXXXXXXXXXXXXXXXXXXX