----------------------------------------------------------------------------------------------------------------------------------------------------------------------------------------------------------------------
----------------------------------------------------------------------------------------------------------------------------------------------------------------------------------------------------------------------
----------------------------------------------------------------------------------------------------------------------------------------------------------------------------------------------------------------------
----------------------------------------------------------------------------------------------------------------------------------------------------------------------------------------------------------------------
-----------------------------------------------------------------------------------------------------------------------------------------------S----------------------------------------------------------------------
----------------------------------------------------------------------------------------------------------------------------------------------------------------------------------------------------------------------
---------#----------------------------------------------------SS------------------------------------------SS-----------------SSS---------------------------------------------------------------------------------SS---
----------------------------------------------------------------------------------------------------------------------------------------------------------------------------------------------------------------------
-------------#-------#------------------------------SSS-------------SSSSS-------------TT------------------------T-------------------------------------S-------------------------------TT------------------------------
----------#--#---##-##----------------------------------------------------------------TT----------------##------TT------------------------------TT----------------TT-----------T------TT------------------------------
---------##--#---#####--------------TT---S--TT----------------------------------SS--SSXXS---TT-----T----##-SSS--TT------TT--SS----TT----tt------TT----------------TT----TT----t-TT----XX----T-----t-------------S-----
--------###--#--######--------------TT------TT----------------TT----------------T-----------TT----TT--T###------TT------TT--------TT----tt------TT---------T------TT----TT----t-TT----------TT---tt---T---------------
------TT-##--#-########-------TT----TT------TT----T-----------TT--T-----TT------TT----------TT----TT-#T###------TT----#-TT--------TT----ttTT----TT----tt--TT------TT--T-TT----ttTT--TT----T-TT---tt--TTT--------------
------TT-##--##########-------TT-k--TT------TT----TT--------#-TT--T-----TT------TT----------TT----TT-#T###------TT----#-TT-----k--TT----t--T-k--TT----tt--TT------TT--T-TT----t-TT--TT----T-TT----t--TTT--------------
XXXXXXXXXXXXXXXXXXXXXXXXXXXXXXXXXXXXXXXXXXXXXXXXXXXXXXXXXXXXXXXXXXXXXXXXXXXXXXXXXXXXXXXXXXXXXXXXXXXXXXXXXXXXXXXXXXXXXXX-XXXXXXXXXXXXXXXXXXXXXXXXXXXXXXXXXXXXXXXXXXXXXXXXXXXXXXXXXXXXXXXXXXXXXXXXXXXXXXXXXXXXXXXXXXXX--
XXXXXXXXXXXXXXXXXXXXXXXXXXXXXXXXXXXXXXXXXXXXXXXXXXXXXXXXXXXXXXXXXXXXXXXXXXXXXXXXXXXXXXXXXXXXXXXXXXXXXXXXXXXXXXXXXXXXXXXXXXXXXXXXXXXXXXXXXXXXXXXXXXXXXXXXXXXXXXXXXXXXXXXXXXXXXXXXXXXXXXXXXXXXXXXXXXXXXXXXXXXXXXXXXXXX--