----------------------------------------------------------------------------------------------------------------------------------------------------------------------------------------------------------------------
----------------------------------------------------------------------------------------------------------------------------------------------------------------------------------------------------------------------
----------------------------------------------------------------------------------------------------------------------------------------------------------------------------------------------------------------------
----------------------------------------------------------------------------------------------------------------------------------------------------------------------------------------------------------------------
---------------------------------------------------------------------------------------------------S------------------------------------------------------------------------------------------------------------------
-------------------------------------#-------------------------#------------------------------------------------------------------------------------------------------------------------------------------------------
-------------------------------------------------------------#-#--##--------------------------------------------------------------------------------------------------------------------------------------------------
-----------------------------------------------------------------###-------------------------------#------------------T------------------------------------------------------------------T----------------------------
-------------------------SS-------------------------------------####----TT--SSS-TT--SS------------##------------------X---------------------------------S------------SS------------------X----------------------------
---------------------------------------------------------------#####----TT------TT---------------###------------------------------------------------------------------------------------------------------------------
-------------------T--------------------TT---------------SS----#####----TT-----------------tt---##---------------SSSSS----------------TT----------------TT------tX----------------------------------------TT--TT------
------------------TT--------------------TT--------------------######----TT-----------------tt-TT##------------------------------------TT----------------TT------------------------------------------------TT--TT------
-----T------------TT----------TTT-----T-TT-----tt------------#######-----T----------TT-----tt-TT-#--#-TT------------------------------TT------#--TTT----TT--TT----TT------TT------TT---------------------TTT--TT------
----TT------------TT----------TT------T-TT-----t------------########----------T-----TT-----tt-TT-#-##-TT------------------------------TT-----##---TT----TT--TT----TT------TT---##-TT--------------------TTTT--TT---#--
XXXXXXXX--XXXXXXXXXXXXXXXX-XXXXXXXXXXXXXXXXXXXXX-XXXXXXXXXXXXXXXXXXXXXXXXXXXXXXXXXXXXXXXXXXXXXXXXXXXXXXXXXXXXXXXXXXXXXXXXXXXXXXXXXXXXXXXXXXXXXXXXXXXXXXXXXXXXXXXXXXXXXXXXXXXXXXXX-XXXXXXXXXX----XXXXXXXXXXXXXXXXXXXXX-
X-XXXXXX--XXXXXXXXXXXXXXX---XXXXXXXXXXXXXXXXXXXXXXXXXXXXXXXXXXXXXXXXXXXXXXXXXXXXXXXXXXXXXXXXXXXXXXXXXXXXXXXXXXXXXXXXXXXXXXXXXXXXXXXXXXXXXXXXXXXXXXXXXXXXXXXXXXXXXXXXXXXXXXXXXXXXXXXXXXXXXXXX----XXXXXXXXXXXXXXXXXXXX-X