----------------------------------------------------------------------------------------------------------------------------------------------------------------------------------------------------------------------
----------------------------------------------------------------------------------------------------------------------------------------------------------------------------------------------------------------------
----------------------------------------------------------------------------------------------------------------------------------------------------------------------------------------------------------------------
----------------------------------------------------------------------------------------------------------------------------------------------------------------------------------------------------------------------
----------------------------------------------------------------------------------------------------------------------------------------------------------------------------------------------------------------------
----------------------------------------------------------------------------------------------------------------------------------------------------------------------------------------------------------------------
------------------------------------------SSSS----------------TT-----------------------SS-------SS--------------SS--------------SS--SSSSSSS-------------------------T-------------------------------SSSSSSSSS---------
--------------------------------------------------------------TT----------------------------------------------------------------------------------------------------T-------------------------------------------------
------------------------SSSSS---------------------------------X-----------------------------------------------------------------------------------------S----------XX---------S---------------------------------------
--------------------------------TT------------------------------------------------------------------------------------------------------------------------------------------------------------------------------------
-----tt---T--2-----tX-----------TT----TT------SS--------TT----S-T--------TTT--------TT--SS--------------TT------------------------------------------------------------------------TT---#--------------TT--------------
------t------------t------------TT----TT----------------TT------TT------TTTT------------------------TT--TT------------------------------------------------------------------------TT--##T-------TT-----T--------------
------t-----------------TT----TTTT----TT--------------T-TT------TT--TT--TTT-------------------------TT--TT-----tt---TTTT----TTTTTT--TT------TT------------------------TT--------TTTT-T##-------#TT---------------tt---
------t--------k---t----TT----TTTT----TT----------------TT------TT--TT---TT--------k-------------k--TT--TT-----tt---TTTT----TT--TT--TT------TT---k--------------------TT--------TTTTTT##------#--T---------------tt---
XXXXXXXXXXXXXXXXXXXXXXXXXXXXXXXXXXXXXXXXXXX-------XXXXXXXXXXXXXXXXXXXXXXXXXXXXXXXXXXXXXXXXXXXXXXXXXXXXXXXXXXXXXXXXXXXXXXXXXXXXXXXXXXXXXXXXXXXXXXXXXXXXXXXXXXXXXXXXXXXXXX--XXXXXXXXXXXXXXXXXXXXXXXXXXXXXXXXXX--XXXXXX--
XXXXXXXXXXXXXXXXXXXXXXXXXXXXXXXXXXXXXXXXXXX-------XXXXXXXXXXXXXXXXXXXXXXXXXXXXXXXXXXXXXXXXXXXXXXXXXXXXXXXXXXXXXXXXXXXXXXXXXXXXXXXXXXXXXXXXXXXXXXXXXXXXXXXXXXXXXXXXXXXXXX--XXXXXXXXXXXXXXXXXXXXXXXXXXXXXXXXXX--XXXXXX--