----------------------------------------------------------------------------------------------------------------------------------------------------------------------------------------------------------------------
----------------------------------------------------------------------------------------------------------------------------------------------------------------------------------------------------------------------
----------------------------------------------------------------------------------------------------------------------------------------------------------------------------------------------------------------------
----------------------------------------------------------------------------------------------------------------------------------------------------------------------------------------------------------------------
----------------------------------------------------------------------------------------------------------------------------------------------------------------------------------------------------------------------
----------------------------------------------------------------------------------------------------------------------------------------------------------------------------------------------------------------------
-------------------------#-----------#-------------SSS------S-----------------------SS--------SS----##------S-------------TT----------------------TT--------------------------SS------------------TT------TT----------
------------------------------------##-------------------------------------------------------------###--------------------TT----------------------TT----------------------------------------------TT----TTT-----------
--------------##---##--------------###------S-------------------------------------------------------##----------------SSS-XX---SSS----------------TT------------------TT------TT----------T-------TT----TT------------
-------------###--##--------------####----------------------------TT-------------------------------###--------------------------------------------XX------------------TT------T-----------TT------TT----TT------------
------------#######-------------TT#####-----------SS---------S----TT-------T--------------------TT-###----------------------XX------TT-----tt--T----------------------XX----SSSS--SSSS----XT------TT----XX------------
------TT---T#########-TT--------TT#####---------------------------TT------TT------------TT------TT-###----------TT------------------TT------t-TT--------TT--------TT-----------------------------TTT------------------
------TT-#TT#########-TT--------TTTT###-----TT----------TT--------TT------TT------------TT------TT-###--TT------TT-##---------------TT------t-TT--------TT--------TT-----------------T----------TTTT------------TT----
------TT-#TT#########-TT---k----TTTT##------TT----------TT-----k--TT------TT------------TT----k-TT-###--TT---##-TT-##------------k--TT------t-TT--------TT--------TT----------------TT------T---TTTT----------k-TT----
XXXXXXXXXXXXXXXXXXXXXXXXXXXXXXXXXXXXXXXXXXXXXXXXXXXXXXXXXXXXXXXXXXXXXXXXXXXXXXXXXXXXXXXXXXXXXXXXXXXXXXXXXXXXXXXXXXXXXXXXXXXXXXXXXXXXXXXXXXXXXXXXXXXXXXXXXXXXXXXXXXXXXXXXXXXXXXX---XXXXXXXXXXXXXXXXXXXXXXXXXXXXXXXXXX--
XXXXXXXXXXXXXXXXXXXXXXXXXXXXXXXXXXXXXXXXXXXXXXXXXXXXXXXXXXXXXXXXXXXXXXXXXXXXXXXXXXXXXXXXXXXXXXXXXXXXXXXXXXXXXXXXXXXXXXXXXXXXXXXXXXXXXXXXXXXXXXXXXXXXXXXXXXXXXXXXXXXXXXXXXXXXXXX---XXXXXXXXXXXXXXXXXXXXXXXXXXXXXXXXXX-X