----------------------------------------------------------------------------------------------------------------------------------------------------------------------------------------------------------------------
----------------------------------------------------------------------------------------------------------------------------------------------------------------------------------------------------------------------
----------------------------------------------------------------------------------------------------------------------------------------------------------------------------------------------------------------------
----------------------------------------------------------------------------------------------------------------------------------------------------------------------------------------------------------------------
----------------------------------------------------------------------------------------------------------------------------------------------------------------------------------------------------------------------
----------------------------------------------------------------------------------------------------------------------------------------------------------------------------------------------------------------------
----TT----TT----T-------TT-----------------------------------------S-------------------------------------------SS-------TT--------------------------------------------------------------------------------------------
-----T----TT----TT------TT##---------------------------##---TT----------------------------------------------------------TT------TT------------------------------------------------------------------------------------
----------XX----TT-----##X##---SSSS-------------------###---XX-----------------------SS-----S---SSSSSS----TT------------X--------X-----------------------------------------SS---------SSS-----------------------------
----------------TT----######-----------------------######-------------------------------------------------TT------------##----------------------------------------------------------------------------##--------------
----S-TT---S----XXS-TT######----------------------######--------------------------------------------------XX---------#--##--------------tt----tt----TT-------------S------------SS------------SS-----#-#--------------
------TT------------TT#####----------------------#######-----------------------------------------------------------------#--------------tt----tt----TT--------------------------------tt------------#--#--------------
------TT------T----#TT#####-TT------------------########--------------TTT---TT--TT------TT----TT---------------------##-##--------TT----tt----tt--TTTT------TT------TTT---------------tt-T---------##-TT--------------
----#-TT------T-----TT#####-TT-----------------#########---------------TT---TT--TT------TT----TT---k---------------#--#-##--------TT----tt----tt--TTTT------TT------TTTT--------------tt-T--------####TT--------------
XXXXXXXXXXXXXXXXXXXXXXXXXXX-XXXXXXXXXXX-XXXXXXXXXXXXXXXXXXXXXXXXX-----XXXXXXXXXXXXXXXXXXXXXXXXXXXXXXXXXXXXXXXXXXXXXXXXXXXXXXXXXXXXXXXXXXXXXXXXXXXXXXXXXXXXXXXXXXXXXXXXXXXXXXXXXXXXXXXXXXXXXXXXXXXXXXXXXXXXXXXXXXXXXX--
XXXXXXXXXXXXXXXXXXXXXXXXXXX-XXXXXXXXXX--XXXXXXXXXXXXXXXXXXXXXXXX------XXXXXXXXXXXXXXXXXXXXXXXXXXXXXXXXXXXXXXXXXXXXXXXXXXXXXXXXXXXXXXXXXXXXXXXXXXXXXXXXXXXXXXXXXXXXXXXXXXXXXXXXXXXXXXXXXXXXXXXXXXXXXXXXXXXXXXXXXXXXXX-X