----------------------------------------------------------------------------------------------------------------------------------------------------------------------------------------------------------------------
----------------------------------------------------------------------------------------------------------------------------------------------------------------------------------------------------------------------
----------------------------------------------------------------------------------------------------------------------------------------------------------------------------------------------------------------------
----------------------------------------------------------------------------------------------------------------------------------------------------------------------------------------------------------------------
----------------------------------------------------------------------------------------------------------------------------------------------------------------------------------------------------------------------
----------------------------------------------------------------------------------------------------------------------------------------------------------------------------------------------------------------------
----------SS-------------------------------------------------------------SSS--------------------------------------------------------------S---------SS----------------------TT----------------TT--SS--SSSS------------
----------------------------------------------------------------------------------------------------------------------------------------------------------------------------TT----------------TT----------------------
----S---S-------SS--------------------------------------------SS--------------------------------------XS--------------------------------------------------ST------------S---XX----------------XX----------------SS----
----------------------------------------------------------------------------------------------------------------------------------------------------------------------------------------------------------------------
------------------------TT----SSSSSSS------------------------------S-----SSS-----TTT----T------TT---------------TT----------------------TT-----------S-------S------------SS------------S-T-----SSSSS-------S---------
------------------------TT--------------TT---------------------------------------TTT----TT-----T--------------TTTT------t--T------------TT--------------TT------TT-------------T----------TT--------------------------
----------------TT----TTTT--------------TT-------------##-------TT----------------TT----TT-----T--------------TTTT-----tt-tT----TT------TT--------------TT------TT------------TTTT---------T--------------------------
----------------TT----TTT---------------TT------------###-------TT------tt--------TT----TT-----T--------------TTTT--------------TT------TT--------------TT------TT------------TTT-------k--T-----------------------#--
XXXXXX----XXXXXXXXXXXXXXXXXXXXXXXXXXXXXXXXXXXXXXXXXXXXXXXXXXXXXXXXXXXXXXXXXXXXXXXXXXXXXXXXXXXXXXXXXXXX--XXXXXXXXXXXXXXXXXXXXXXXXXXXXXXXXXXXXXXXXXXXXXXXXXXXXXXXXXXXXXXXXXXXXXXXXXXXXXXXXXXXXXXXXXXX---XXXXXXXXXXXXXXXX
XXXXXX----XXXXXXXXXXXXXXXXXXXXXXXXXXXXXXXXXXXXXXXXXXXXXXXXXXXXXXXXXXXXXXXXXXXXXXXXXXXXXXXXXXXXXXXXXXXX--XXXXXXXXXXXXXXXXXXXXXXXXXXXXXXXXXXXXXXXXXXXXXXXXXXXXXXXXXXXXXXXXXXXXXXXXXXXXXXXXXXXXXXXXXXX---XXXXXXXXXXXXXXXX