------------------------------------------------------------------------------------------------------------------------------------------------------------------------------------------------------
------------------------------------------------------------------------------------------------------------------------------------------------------------------------------------------------------
------------------------------------------------------------------------------------------------------------------------------------------------------------------------------------------------------
------------------------------------------------------------------------------------------------------------------------------------------------------------------------------------------------------
------------------------------------------------------------------------------------------------------------------------------------------------------------------------------------------------------
------------------------------------------------------------------------------------------------------------------------------------------------------------------------------------------------------
------------------------------------##----------------------------------------------------------------------------------------------------------------------------------------------------------------
------------------------------------##----------------------------------------------------------------------------------------------------------------------------------------------------------------
---------------------------#-----#--##-------------------------------------------------------------------------------------------------------------------K--------------------------------------------
---------------------------------#--##----------------------------------------------------------------------------------------------------------------------------------------------------------------
---------------------------------#--##--------#-------------------------------------------------------------------------------------------------------------------------------------------------##----
---------------------------------#---#-----#----------------------------------------------------------------------------------------------------------------------------------------------------------
--------TT------------------*----#----*----#-----------------------------------------------------------------------*---------------------*-----------*------------------------------------------------
--------TT-----------ggg----*----*----*----#------------ggg-----------ggg----ggg-----ggg-----------------ggg-------*-----ggg----gg-------*---ggg-----*-------ggg----g------ggg---------gg-------------
XXXXXXXXXXXXXXXXXXXXXXXXXXXXXXXXXXXXXXXXX--XXXXXXXXXXXXXXXXXXXXXXXXXXXXXXXXXXXXXXXXXXXXXXXXXXXXXXXXXXXXXXXXXXXXXXXXXXXXXXXXXXXXXXXXXXXXXXXXXXXXXXXXXXXXXXXXX--XXXXXXXXXXXXXXXXXXXXXXXXXXXXXXXXXXXXXXXX
XXXXXXXXXXXXXXXXXXXXXXXXXXXXXXXXXXXXXXXXX--XXXXXXXXXXXXXXXXXXXXXXXXXXXXXXXXXXXXXXXXXXXXXXXXXXXXXXXXXXXXXXXXXXXXXXXXXXXXXXXXXXXXXXXXXXXXXXXXXXXXXXXXXXXXXXXXX--XXXXXXXXXXXXXXXXXXXXXXXXXXXXXXXXXXXXXXXX