------------------------------------------------------------------------------------------------------------------------------------------------------------------------------------------------------
------------------------------------------------------------------------------------------------------------------------------------------------------------------------------------------------------
------------------------------------------------------------------------------------------------------------------------------------------------------------------------------------------------------
------------------------------------------------------------------------------------------------------------------------------------------------------------------------------------------------------
----------------------------------------------------------------------------------------------------------------TT------------------------------------------------------------------------------------
----------------------------------------------------------------------------------------------------------------TT------------------------------------------------------------------------------------
-----------------------------------------------------------------------------------------------------------SUS--##------------------------------------------------------------------------------------
------------------------------------------------------------------------------------------------------------------------------------------------------------------------##----------------------------
------------------------------------------------------------------------------------------------------------------------------------------------------------------------##----------------------------
----------------------------------------------------------------------------------------------------------------##-------------------------------------#----------------##----------------------------
-------------------------------------------------------#------------------#---------------------------------##-###--#-----------------------##--------##-------------#--##--------#LSS----------------
------------------------K------------------------------#---------------------------------------------------#######---------------------------#-----#--##-------------#--##--------#-------------------
---------------------------------------------*-------------------------------------------------------------#######-----------------T---------------#------------*--###------------#-------TT----------
----gg------------------------ggg------------*--------------k-------------------------------------ggg-----########--------gg------TT--------------##-----gg-----*-#--#--------g-k-#--------TT---------
XXXXXXXXXXXXXXXXXXXXXXXXXXXXXXXXXXXXXXXXXXXXXXXXXXXXXXXXXXXXXXXXXXXXXXXXXXXXXXXXXXXXXXXXXXXXXXXXXXXXXXXXXXXXXXXXXXXX--XX--XXXXXXXXXXXXXXXX--XXXXXXXXXXXXXXXXXXXXXXX--XXXXXXXXXXXXXXXXXXXXXXXXXXXXXXXXX
XXXXXXXXXXXXXXXXXXXXXXXXXXXXXXXXXXXXXXXXXXXXXXXXXXXXXXXXXXXXXXXXXXXXXXXXXXXXXXXXXXXXXXXXXXXXXXXXXXXXXXXXXXXXXXXXXXXX--XX--XXXXXXXXXXXXXXXX--XXXXXXXXXXXXXXXXXXXXXXX-XXXXXXXXXXXXXXXXXXXXXXXXXXXXXXXXXX