------------------------------------------------------------------------------------------------------------------------------------------------------------------------------------------------------
------------------------------------------------------------------------------------------------------------------------------------------------------------------------------------------------------
------------------------------------------------------------------------------------------------------------------------------------------------------------------------------------------------------
------------------------------------------------------------------------------------------------------------------------------------------------------------------------------------------------------
------------------------------------------------------------------------------------------------------------------------------------------------------------------------------------------------------
------------------------------------------------------------------------------------------------------------------------------------------------------------------------------------------------------
-------------------------------------S---------------------------------------------------------------------------------------------------------------------------------------------S----##------------
----------------------------------------------------------------------------------------------------------------------------------------------------------------------------------------##------------
-----------------------------------------------#------------------------------------------------------------------------##-----------------S-----------------------------------------K--##------------
----------------------------------------------##------------------------------------------------------------------------##-----------------------------------------#--------------------##------------
-------------------------------------------#-###-----------------------------##----------------------------#--------#---##------------------#LSS------------------##-------------------###------------
-------------------------------------------#--##------------TT---------------------------------------------#------------##-------TT---------#---------------------##-----------------#####------------
--------------------------------------*---##--##------------TT--------TT----##----------------TT-----------#---------------------TT---------#-----TT--------------------------------####--------------
-------K---gg----ggg-----------ggg----*----#---#----------kkTT--------TT----#--------ggg------TT---K-------#--------------------kTT-------kk#-----TT----gg-------------T-ggg-------#####-----ggg------
XXXXXXXXXXXXXXXXXXXXXXXXXXXXXXXXXXXXXXXXX--XXXXXXXXXXXXXXXXXXXXXXXXXXXXXXXXXXXXXXXXXXXXXXXXXXXXXXXXXXXXXXXXXXXXXXXXXXXXXXXXXXXXXXXXXXXXXXXXXXXXXX-XXXXXXXXXXXXXXXXXXXXXXXXXXXXXXXXXXXXXXXXXXXXXXXXXXXX
XXXXXXXXXXXXXXXXXXXXXXXXXXXXXXXXXXXXXXXXX--XXXXXXXXXXXXXXXXXXXXXXXXXXXXXXXXXXXXXXXXXXXXXXXXXXXXXXXXXXXXXXXXXXXXXXXXXXXXXXXXXXXXXXXXXXXXXXXXXXXXXX-XXXXXXXXXXXXXXXXXXXXXXXXXXXXXXXXXXXXXXXXXXXXXXXXXXXX