------------------------------------------------------------------------------------------------------------------------------------------------------------------------------------------------------
------------------------------------------------------------------------------------------------------------------------------------------------------------------------------------------------------
------------------------------------------------------------------------------------------------------------------------------------------------------------------------------------------------------
------------------------------------------------------------------------------------------------------------------------------------------------------------------------------------------------------
------------------------------------------------------------------------------------------------------------------------------------------------------------------------------------------------------
------------------------------------------------------------------------------------------------------------------------------------------------------------------------------------------------------
-------------------------------------------------------SUS--------------------------------------------------------------------------------------------------------------------------------------------
---------------------------------------------------------------------------T-----------------------------------------------------------------------------------------------#--------------------------
--------------------------------------------##----------------------------------------------------------------------------------------------------------------------------##--------------------------
--------------------------------------------##----------------------------------------------------------------------------------------------------------------------------##--------------------------
--------------------------------------------##-----------------------------#---------------------------#------#LSS-------------#--#-----------------------------------#LS###----#---------------------
----------------------------------#------#--##--------------------------------------------------------##------#---------------#---#-----------------------------TT----#-------------------------------
---------------------------------------------------------------------------#----------------------*----#------#--------------K#--------------*-----*------------TT----#-------------------------------
------------------------------#-----------------------k-------gg--------#--#----------ggg---------#----#-----k#-------#-------#---##---------*-----*--------k---TT--kk#------------------ggg------#---
XXXXXXXXXXXXXXXXXXXXXXXXXXXXXXXXXXXXXXXXXXXXXXXXXXXXXXXXXXXXXXXXXXXXXXXXXXXXXXXXXXXXXXXXXXXXXXXXXXXXXXXXXXXXXXXXXXX---XXXXXXXXXXXXXXXXXXXXXXXXXXXXXXXXXXXXXXXXXXXXXXX---XXX---XXXXXXXXXXXXXXXXXXXXXXXX
XXXXXXXXXXXXXXXXXXXXXXXXXXXXXXXXXXXXXXXXXXXXXXXXXXXXXXXXXXXXXXXXXXXXXXXXXXXXXXXXXXXXXXXXXXXXXXXXXXXXXXXXXXXXXXXXXXX---XXXXXXXXXXXXXXXXXXXXXXXXXXXXXXXXXXXXXXXXXXXXXXX---XXX---XXXXXXXXXXXXXXXXXXXXXXXX