------------------------------------------------------------------------------------------------------------------------------------------------------------------------------------------------------
------------------------------------------------------------------------------------------------------------------------------------------------------------------------------------------------------
------------------------------------------------------------------------------------------------------------------------------------------------------------------------------------------------------
------------------------------------------------------------------------------------------------------------------------------------------------------------------------------------------------------
------------------------------------------------------------------------------------------------------------------------------------------------------------------------------------------------------
------------------------------------------------------------------------TT----------------------------------------------------------------------------------------------------------------------------
------------------------------------------------------------------------##-------------------------------------------------------------SUS------------------------------------------------------------
------------------------------------------------------------------------##----------------------------------------------------------------------------------------------------------------------------
----------TT------------------------------------------------------------##-------------------------------------------SUS------------------------------------------------------------------------------
----------TT------------------------------------------------------------##----------------------------------------------------------------------------------------------------------------------------
----------##-----------------------------------------------------------###--------#LSS---#--------------------------------------------######----------------------------------------------------------
--------------------------------------------TT-------------------#----------------#-----------------------------TT--------------------#----------------------------------------TT-----TT--------------
----------##--------------------------TT----TT------------TT----------------------#-----------------------------TT-------------------K#----------------------------------------TT-----TT--------------
----------##------gg------------------TT----TT-----K------TT-----#--------------k-#--------------ggg----------k-TT--------g---k-------#----------ggg-----ggg------------------kTT---kkTT-----gg-------
XXXXXXXXXXXXXXXXXXXXXXXXXXXXXXXXXXXXXXXXXX--XXXX--XXXXXXXXXXXXXXXXXXXXXXXXXXXXXXXXXXXX----XXXXXXXXXXXXXXXXXXXXXXXXXXXXXXXXXXXXXXXXXXXXXX-----XXXXXXXXXXXXXXXXXXXXXXXXXXXXXXXXXXXXXXXXXXXXXXXXXXXXXXXXX
XXXXXXXXXXXXXXXXXXXXXXXXXXXXXXXXXXXXXXXXXX--XXXX--XXXXXXXXXXXXXXXXXXXXXXXXXXXXXXXXXXXX-----XXXXXXXXXXXXXXXXXXXXXXXXXXXXXXXXXXXXXXXXXXXXX-----XXXXXXXXXXXXXXXXXXXXXXXXXXXXXXXXXXXXXXXXXXXXXXXXXXXXXXXXX