------------------------------------------------------------------------------------------------------------------------------------------------------------------------------------------------------
------------------------------------------------------------------------------------------------------------------------------------------------------------------------------------------------------
------------------------------------------------------------------------------------------------------------------------------------------------------------------------------------------------------
------------------------------------------------------------------------------------------------------------------------------------------------------------------------------------------------------
------------------------------------------------------------------------------------------------------------------------------------------------------------------------------------------------------
------------------------------------------------------------------------------------------------------------------------------------------------------------------------------------------------------
---SSS------------------------------------------------------------------------------------------------------------------------------------------------------------------------------------------------
------------------------------------------------------------------------------------------------------------------------------------------------------------------------------------------------------
---------------------------------------------------------------------------------------------------------------------------------------S--------------------------------------------------------------
----------------------------------------------------------------------------------------------------------------------------------------------------------------------------------------##------------
----------------------------------------------------##---------------------------------------------------------------------------#---------#-----#--------------------------------------##------------
--------T--------------------------------K------#--------------------------------------------------------------------------------#------------------------------------------------------##------------
--------T---------------------TT---------*------#-----------------TT-----*-----*-------------------------------------------------#-----##-------------------T-----TT----------------------------------
--------T-------------------k-TT---------*------#------------gg---TT-----*-----*-----------ggg---ggg-----------ggg---------gg----#----##--------------k-----------TT----------------------------------
XXXXX--XXXX-----XXXX--XXXXXXXXXXXXXXXXXXXXXXXXXXXXX----XXXXXXXXXXXXXXXXXXXXXXXXXXXXXXXXXXXXXXXXXXXXXXXXXXXXXXXXXXXXXXXXXXXXXXXXXXXXXXXXXXXXX--XXXXXXXXXXXXXXXXXXXXXXXXXXXXXXXXXXXXXXXXXXXXXX--XXXXXXXX
XXXXX--XXXX-----XXXX--XXXXXXXXXXXXXXXXXXXXXXXXXXXXX----XXXXXXXXXXXXXXXXXXXXXXXXXXXXXXXXXXXXXXXXXXXXXXXXXXXXXXXXXXXXXXXXXXXXXXXXXXXXXXXXXXXXX--XXXXXXXXXXXXXXXXXXXXXXXXXXXXXXXXXXXXXXXXXXXXXX--XXXXXXXX