------------------------------------------------------------------------------------------------------------------------------------------------------------------------------------------------------
------------------------------------------------------------------------------------------------------------------------------------------------------------------------------------------------------
------------------------------------------------------------------------------------------------------------------------------------------------------------------------------------------------------
------------------------------------------------------------------------------------------------------------------------------------------------------------------------------------------------------
------------------------------------------------------------------------------------------------------------------------------------------------------------------------------------------------------
------------------------------------------------------------------------------------------------------------------------------------------------------------------------------------------------------
-------------------------------------------------------------------------------------------------------------------------------------------------------SSS--------------------------------------------
------------------------------------------------------------------------------------------------------------------------------------------------------------------T-----------------------------------
-----------------------------------------------------------------------------------------------------------------------------------------------------#-----------#------------------------------------
-----------------------------------------------------------------------------------------------------------------------------------------------------#----------#-------------------------------------
----------#-------------------------------------------------------------------------------------------------#LSS-----------------------------------###--#####---##---------###------------------------
----------#---T---------------------------------------------------------T-----------------------------------#--------------------------------------#--------------------------------------------------
----------#---T----------------------------------*----------------------TT--------------TT------------------#-------------------------------------K--------#-------------#--------------T-----TT-----X
--------------T-------ggg----------ggg--------g-g*-----*-g-g--------k---TTg-------------TT--------g-g-----k-#-----ggg--------gggg-----gg--ggg--------------#------------#---#-----------TT----TT----XX
XXXXXXXXXXXXXXXXXXXXXXXXXXXXXXXXXXXXXXXXXXXXXXXXXXXXXXXXXXXXXXXXXXXXXXXXXXXXXXXXXXXXXXXXXXXXXXXXXXXXXXXXXXXXXXXXXXXXXXXXXXXXXXXXXXXXXXXXXXXXXXXXXXXX---------X------XXXXXXXXXXXXXXXXXXXXXXXXXXXXXXXXXX
XXXXXXXXXXXXXXXXXXXXXXXXXXXXXXXXXXXXXXXXXXXXXXXXXXXXXXXXXXXXXXXXXXXXXXXXXXXXXXXXXXXXXXXXXXXXXXXXXXXXXXXXXXXXXXXXXXXXXXXXXXXXXXXXXXXXXXXXXXXXXXXXXXXX----------------XXXXXXXXXXXXXXXXXXXXXXXXXXXXXXXXXX