----------------------------------------------------------------------------------------------------------------------------------------------------------------------------------------------------
----------------------------------------------------------------------------------------------------------------------------------------------------------------------------------------------------
----------------------------------------------------------------------------------------------------------------------------------------------------------------------------------------------------
----------------------------------------------------------------------------------------------------------------------------------------------------------------------------------------------------
----------------------------------------------------------------------------------------------------------------------------------------------------------------------------------------------------
----------------------------k#--#-------------------------------------------------------------------------------------------------------------------------------------------------------k-----------
---------------------------######------------------------------------------------------------------------------##---------------SS-----------------------------------------------------SQS----------
--------------------------#######-----------------------------------------------------------------------------###-----------------------------------------------------------------------------------
-------------------------########--------------------------------g##----------SS--S--------------------------####------------------------Q----------------------------------------------------------
------------------------#########-------------------------------g###----------------------g-----gg--g-g-----#####------------------------------------------------------------------------g----------
-----------SCSSS-------##########-------------------------------####--------TT------------###########-----######--------------####------------------------------##----------TT-----------##---------
-------------K--------###########--------------------T---------#####--------TT----------------------------######------------------------------------------------#---------k-TT------#-----#---------
---------------------########---#-------------TT-----T--------######--------TT---------------------------#######----------------##----------------------------###-----------TT-----##-----#---------
----------KK--KK----########----#-----------ggTT-----T--------######--------TT--------------------------########----------K-----##--------------ggg-------k---###-------gg--T-----###-----#---------
XXXXXXXXXXXXXXXXXXXXXXXXXXXX----XXXXXXXXXXXXXXXXXXXXXXXXX---XXXXXXXXXXXXXXXXXXXXXXXXXXXXX-------------XXXXXXXXXXXXXXXXXXXXXXXXXXXXX---XXXXXXXXXXXXXXXXXXXXXXXXXXXXXXXXXXXXXXXXXXXXXXX---XXX---XXXXXX
XXXXXXXXXXXXXXXXXXXXXXXXX-X#----XXXXXXXXXXXXXXXXXXXXXXXXX---XXXXXXXXXXXXXXXXXXXXXXXXXXXXX-------------XXXXXXXXXXXXXXXXXXXXXXXXXXXXX---XXXXXXXXXXXXXXXXXXXXXXXXXXXXXXXXXXXXXXXXXXXXXXX---XXX---XXXXXX