----------------------------------------------------------------------------------------------------------------------------------------------------------------------------------------------------
----------------------------------------------------------------------------------------------------------------------------------------------------------------------------------------------------
----------------------------------------------------------------------------------------------------------------------------------------------------------------------------------------------------
----------------------------------------------------------------------------------------------------------------------------------------------------------------------------------------------------
----------------------------------------------------------------------------------------------------------------------------------------------------------------------------------------------------
----------------------------------------------------------------------------------------------------------------------------------------------------------------------------------------------------
--------------------------------------------------------------------------------------------------------------------SSSSSSCS---------------SSS--------------#---------------------------------------
-------------------------------------------------------------------g#------------------------------------------------------K-------------------------------##---------------------------------------
-------------------------------------------------------------------##-------------------------------------------------------------------------------------###-------SQS-----S-----------------------
-------------------------------------g#---------------------------###----------------------------------------------------K----------------------------------#---------------------------------------
-------T----------------------------###-----------------------#######---------------SQSS------------------TT---------S-SSSSS----CS---SSSSS-S---------------####----------------------T--------------
------TT----------TT----------------###-------------------------###-#-------------------------------TT----TT---------------------K--------------------#----##-#---------------------TT--------------
------TT-----T----TT----------ST----####--------------------##--##--#-----------TT------------TT----TT----TT----------------------------------------------#####---------------------TT--------------
--k---TT----TT--ggTT---------g#-----####----k---gg----T----###--#-------------gg-T----K---k---TT----TT----TT----------------------------------------------#####--------g-----------gTT----------#---
XXXXXXXXXXXXXXXXXXXXXXXXXXXXXXX----XXXXXXXXXXXXXXXXXXXXXXXXXXX--XX---------XXXXXXXXXXXXXXXXXXXXXXXXXXXXXXXXXXXXXXXXXXXXXXXXXXXXXXXXXXXXXXXXXXXXXXXXXXXXXXXXXXXXXXXXXXXXXXXXXXXXXXXXXXXXXXXXXXXXXXX--
XXXXXXXXXXXXXXXXXXXXXXXXXXXXXXX----XXXXXXXXXXXXXXXXXXXXXXXXXXX--X----------XXXXXXXXXXXXXXXXXXXXXXXXXXXXXXXXXXXXXXXXXXXXXXXXXXXXXXXXXXXXXXXXXXXXXXXXXXXXXXXXXXXXXXXXXXXXXXXXXXXXXXXXXXXXXXXXXXXX-XX--