----------------------------------------------------------------------------------------------------------------------------------------------------------------------------------------------------
----------------------------------------------------------------------------------------------------------------------------------------------------------------------------------------------------
----------------------------------------------------------------------------------------------------------------------------------------------------------------------------------------------------
----------------------------------------------------------------------------------------------------------------------------------------------------------------------------------------------------
----------------------------------------------------------------------------------------------------------------------------------------------------------------------------------------------------
------------------------------------------k---------------------------------------------------------------------------------------------------------------------------------------------------------
--------------SS-S-----------------------##-------------------S-------------SS------S---------------------------------------SSSS-S-------------------------------------------------Q----------------
----------------------------------------##----------------------------------------------------------------------------------------------------------------------------------------------------------
-----QSS-------------------------------###--------#-----------------------------------------------S----------g#-------------------------------QS----------------------------------------------------
-------K-------------------------------###-------g#-----------#-----------------------------------S----------##-----------------------------------------------------------------------------#-------
-----------SSSSSSS--------SSSSSSCS----####-----####----------###-----------#S-------S-------------#-----------#--------##-----SS------------------SSS----------------------------SSSSSSS----#-------
---------------------------------K---#####--------#----------###------------#--------------------##---------###-------------------------------------------TT----------TT--TT---------------###------
------------------------------------######------------------####---------------------------------##--------#-##------------------------------------------TTT----------TT--TT---------------###------
------------------ggg----------K----######--------------k--#####--gg------gg----k-----------k-----#-------#-###------------------------------------------TT-------k---TT--TT--------------####------
XXXXXXXXXXXXXXXXXXXXXXXXXXXXXXXXXXXXXXXXXX----X------XXXXXXXXXXXXXXXXXXXXXXXXXXXXXXXXXXXXXXXXXXXXXXXXXXXXXXXXXX---XXX--------XXXXXXXXXXXXXXXXXXXXXXXXXXXXXXXXXXXXXXXXXXXXXXXXXXXXXXXXXXXXXX-XX------
XXXXXXXXXXXXXXXXXXXXXXXXXXXXXXXXXXXXXXXXXX----X------XXXXXXXXXXXXXXXXXXXXXXXXXXXXXXXXXXXXXXXXXXXXXXXXXXXXXXXXXX---XXX--------XXXXXXXXXXXXXXXXXXXXXXXXXXXXXXXXXXXXXXXXXXXXXXXXXXXXXXXXXXXXXX-XX------