----------------------------------------------------------------------------------------------------------------------------------------------------------------------------------------------------
----------------------------------------------------------------------------------------------------------------------------------------------------------------------------------------------------
----------------------------------------------------------------------------------------------------------------------------------------------------------------------------------------------------
----------------------------------------------------------------------------------------------------------------------------------------------------------------------------------------------------
----------------------------------------------------------------------------------------------------------------------------------------------------------------------------------------------------
--------------------------------------------------------------------------------------------------k-----------------------------------------------------------------k---------------------------k---
-------------------------------USS-------------------------------------------SSS------------------SS----------------------SSSS------------------SSSS---------------SQS-----------S-S----------------
--------------------------------------------------------------------------------------#---------------------------------------------------------------------------------------------------------#---
-------------------------------------------------------------------------------------##---------------------------------------#-----------------------------------------------------------------#---
--------------------------------#---------------------------------------------------###---------------------------------------g-----------------g#--------------------------------#------------##---
-------------T-------TT-------###----Q---TS-----S-----------TT----------------SSSS-#####-###########----------TT---------######----SCS---SCS---###----------------------------#####----------####---
------TT----TT-------TT------#-##---------------K-----------TT--------------------######----------------------TT---------------------K-----K---###---------------TT----------###--#---------##--#---
------TT----TT-------TT-----##--#---------------TT-----T----TT--------------------######----------------------TT--------------#---------------####---------------TT---------####--#--------###------
-------T----TT--T----TT----###-##-------ggT-----TT-----T----TT--------K----------#######--------------------ggTT-------------------K-----K---#####---------------TT---------####--#---gg----##------
--XXXXXXXXXXXXXXXXXXXXXXXXXXXXXXX-XXXXXXXXXXXXXXXXXXXXXXXXXXXXXXXXXXXXXXXXXXXXXXXXXXXXXX-----------------XXXXXXXXXXXXXXXXX----XXXXXXXXXXXXXXXXXXXXXXXXXXXXXXXXXXXXXXXXXXXXXXXXXXXXXXXXXXXXXXXX------
--XXXXXXXXXXXXXXXXXXXXXXXXXXXXXXXXXXXXXXXXXXXXXXXXXXXXXXXXXXXXXXXXXXXXXXXXXXXXXXXXXXXXXX-----------------XXXXXXXXXXXXXXXXX-----XXXXXXXXXXXXXXXXXXXXXXXXXXXXXXXXXXXXXXXXXXXXXXXXXXXXXXXXXXXXXXX------