----------------------------------------------------------------------------------------------------------------------------------------------------------------------------------------------------
----------------------------------------------------------------------------------------------------------------------------------------------------------------------------------------------------
----------------------------------------------------------------------------------------------------------------------------------------------------------------------------------------------------
----------------------------------------------------------------------------------------------------------------------------------------------------------------------------------------------------
----------------------------------------------------------------------------------------------------------------------------------------------------------------------------------------------------
------------------------------------------------------------------------------k---------------------------------------------------------------------------------------------------------------------
------------------------------------------------------SQS-SS-----------------SSS##--------------------------------------------------------k---------------------------------------------------------
------------------------------------------------------------------------------------------k-----------------------------------------------##--------------------------------------------------------
--------------------------------------------SSSSS-----------------------------------------k-------------##-------------------------------###--------------------------------SSS---------------------
----------------------------k-------------------------------------------------------------g-----------g##-------------------------------####--------------------#-----------------------------------
--------TT---------------SSSSSS--------------------SSSSSSSSSQSSSQS------SQ------S---------###--------####------------------------------#####------------------###--------------------SS---SS--------
----TT--TT---------------------------------------------------------------------------------##-------#####-----------------------------#####----------T-------####-----------------------------------
----TT--TT-------------------------------------------------------------------------------####-----####--#-------TT------TT-----T-----######---------TT------#####---------------------TT------------
----TT--TT------------------gg----gg--------------------k---K-------k-----------g-------#####----######-#-------TT----g-TT----TT---g#######-------ggTT-----######-----k-----------k---TT------------
XX--XXXXXXXXXXXXXXXXXXXXXXXXXXXXXXXXXXXXXXXXXXXXXXXXXXXXXXXXXXXXXXXXXXXXXXXXXXXXXXXXXXXXXXXXXXXXXXXXXXXXXXXXXXXXXXXXXXXXXXXXXXXXXXXXXXXXX-X---XXXXXXXXXXXXXXXXXXX-XXXXXXXXXXXXXXXXXXXXXXXXXXXXXXXXXX
XX--XXXXXXXXXXXXXXXXXXXXXXXXXXXXXXXXXXXXXXXXXXXXXXXXXXXXXXXXXXXXXXXXXXXXXXXXXXXXXXXXXXXXXXXXXXXXXXXXXXXXXXXXXXXXXXXXXXXXXXXXXXXXXXXXXXXX--X---XXXXXXXXXXXXXXXXXXX-XXXXXXXXXXXXXXXXXXXXXXXXXXXXXXXXXX