----------------------------------------------------------------------------------------------------------------------------------------------------------------------------------------------------
----------------------------------------------------------------------------------------------------------------------------------------------------------------------------------------------------
----------------------------------------------------------------------------------------------------------------------------------------------------------------------------------------------------
----------------------------------------------------------------------------------------------------------------------------------------------------------------------------------------------------
------------------------------------------S---------------------------------------------------------------------------------------------------------------------------------------------------------
------------------------------------------K---------------------------------k-----------------------------------------------------------------------k-----------------------------------------------
----------------------SQ--------------------SSS-----------------------------#S----S-----SQSSQS-----------------------------------SS----------------SQS--------------SQSSSSSS------------g##---------
--------------------------------------------------------------k------------##------------------------------------------------------------------------------------------------------------##---------
-----------------------------------SSSSS----------------------k-----------###-----------------------------------------------------------------------------------------------------------####--------
--------------------------------------------------------------k-----------###-----------------------------------------g---------ggS----------------------------------------------------#####--------
------TT--------------S------------------------------S------####---Q-----##########----SSSSSQSSSSS------TT---SCS-S----######---####---------------SSS---------SSSSSS?SSSSS------------######-####---
------TT----TT--#------------------------------------------#####--------#####-----#---------------------TT-----K-------------------------T------------------------------------------#######---------
------TT----TT--##------------------------#----------------#####-------#####------#---------------------T---------------------------------------------------------------------------########--------
------TT----TT---#----gg--------k---------#-----------K----#####------------------#---#-S-------gg--T--------K--------------------------g---------K-----------------gg--------------########--------
XXXXXXXXXXXXXXXXXXXX--XXXXXXXXXXXXXXXXXXXXXXXXXXXXXXXXXXXXXXXXXXXX----------------XXXXXXXXXXXXXXXXXXXXXXXXXXXXXX--------------------XXXXXXXXXXXXXXXXXXXXXXXXXXXXXXXXXXXXXXXXXXXXX---XXXXXXXX--------
XXXXXXXXXXXXXXXXXXXX--XXXXXXXXXXXXXXXXXXXXXXXXXXXXXXXXXXXXXXXXXXX-----------------XXXXXXXXXXXXXXXXXXXXXXXXXXXXX---------------------XXXXXXXXXXXXXXXXXXXXXXXXXXXXXXXXXXXXXXXXXXXXX---XXXXXXXX--------