----------------------------------------------------------------------------------------------------------------------------------------------------------------------------------------------------
----------------------------------------------------------------------------------------------------------------------------------------------------------------------------------------------------
----------------------------------------------------------------------------------------------------------------------------------------------------------------------------------------------------
----------------------------------------------------------------------------------------------------------------------------------------------------------------------------------------------------
----------------------------------------------------------------------------------------------------------------------------------------------------------------------------------------------------
----------------------------------------------------------------------------------------------------------------------------------------------------------------------------------k-----------------
------------------S---S----------------------------------------------------------##-----------------------------------------------SS-S--------------S-----------------S----------S------------------
----------------------------------------#-----------------------------------------------------------------------------------------------------------------------------------------------------------
---------------------------------------##-------SQ--------------------------------##----------------------------------------------------------------------------------------------------------------
--------------------------------------###-----------------------------------------g#------------------------------------------------------------------------------#----ggg--------------------------
--------------TT----------S--------######-----------------------TT---####-----######------------T---------T---------T-----S---------------#----------SS---------##--#######---------TT----TT--------
--------------TT------------------#######-------------TT--------TT--###-----------#-------------T--------TT-------k-TT-----------------------------------------##---------------T---TT----TT--------
--------------TT-----------------########-------------TT---------T-####----------------------------------TT---------TT----------------------------------------####--------------TT--TT----TT--------
---------g----TT----------K----g#########---------k---TT----k----T-#####-----------------------T----k----TT-----k---TT----------k------------g----gg----------####--------------TT--TT--ggTT-----#--
---XXXXXXXXXXXXXXX--XXXXXXXXXXXXXXXXXXXXX-XXXXXXXXXXXXXXXXXXXXXXXXXXXXXXX---------X-----XXXXXXXXXXXXXXXXXXXXXXXXXXXXXXXXXXXXXXXXXXXXXXX-------XXXXXXXXXXXXXXXXXXXX----------XXXXXXXXXXXXXXXXXXXXXXXX
--XXXXXXXXXXXXXXXX--XXXXXXXXXXXXXXXXXXXXXXXXXXXXXXXXXXXXXXXXXXXXXXXXXXXXX---------X-----XXXXXXXXXXXXXXXXXXXXXXXXXXXXXXXXXXXXXXXXXXXXXXX-------XXXXXXXXXXXXXXXXXXXX---------XXXXXXXXXXXXXXXXXXXXXXXXX