----------------------------------------------------------------------------------------------------------------------------------------------------------------------------------------------------
----------------------------------------------------------------------------------------------------------------------------------------------------------------------------------------------------
----------------------------------------------------------------------------------------------------------------------------------------------------------------------------------------------------
----------------------------------------------------------------------------------------------------------------------------------------------------------------------------------------------------
----------------------------------------------------------------------------------------------------------------------------------------------------------------------------------------------------
----------------------------------------------------------------------------------------------------------------------------------------------------------------------------------------------------
---------------------------S--------------------------------------------------------------##----SS---------------SSSS-----SS------------------------------------------------S---------SQSS----------
-----------------------------------------------------------------------------------ggg----#---------------------------------------------------------------------------------------------------------
----------------------------------------------------SS------SSS--------------------###----#----------------------------------------------------------------------SSS--------------------------------
------------------------#-----------------------------------------------------------#-----#-----------------------------##----------------------------------gg--------------------------------------
------SS----------------#-----------TT---S--#-----------------------S--------S----###-----#---SS?SSSS------------SS----##-------------------SS-----------######-----------SQS----SSS--SSSSS---------
-------K---------------###----------TT------#-------------------------------------###-----#---------------T-----------###---------------------------------------------------------------------------
---------------------##-##----------TT------##------------------------------------###-----#---------------TT---------####---------------------------------------------------------------------------
--------------------###-##-----ggg--TT---K--##------------------------------------###-----#---K---K-------T---gg-----####--------gg---TT------k-------------------k-------gg----g---------K------#--
XXXXXXXXXXXXXXXXXXXXXXXXXXXXXXXXXXXXXXXXXXXXXXX----XXXXXXXXXXXXXXXXXXXXXXX----XXXXXXX---XXXXXXXXXXXXXXXXXXXXXXXXXXXXXXXXXXXXXXXXXXXXXXXXXXXXXXXXXXXXXXXXX-----XX--XXXXXXXXXXXXXXXXXXXXXXXXXXXXXXXXXX
XXXXXXXXXXXXXXXXXXXXXXXXXXXXXXXXXXXXXXXXXXXXXXX----XXXXXXXXXXXXXXXXXXXXXXX----XXXXXXX---XXXXXXXXXXXXXXXXXXXXXXXXXXXXXXXXXXXXXXXXXXXXXXXXXXXXXXXXXXXXXXXXX-----X---XXXXXXXXXXXXXXXXXXXXXXXXXXXXXXXXXX