----------------------------------------------------------------------------------------------------------------------------------------------------------------------------------------------------
----------------------------------------------------------------------------------------------------------------------------------------------------------------------------------------------------
----------------------------------------------------------------------------------------------------------------------------------------------------------------------------------------------------
----------------------------------------------------------------------------------------------------------------------------------------------------------------------------------------------------
----------------------------------------------------------------------------------------------------------------------------------------------------------------------------------------------------
------------------------------k-------------------------------------------------------------------------------------------k-----------------------------------------------------------k-------------
-----------------------------SQS-SQS-------------S---------------------------------------------##------------------------SSSSSSS---SQS----S------------------------------------------SQS--S?SSCS----
------------------------------------------------------------------##ggg-----------------------------------------------------------------------------------------k------------------------------K----
--------------#-------------------------------------------------#######------------##---------------------------------------------------------------------------QS----------------------------------
------------g##---------------#--------------------------------########-----------###--------------------------------------------------------------------------------------------------------K------
-----------####---------------#SSS--S-------------##----------#########----------####---------#---------------------SSSSSSSSS-#----SCS----SS---------------SSS--------T---------TT--SSSS--SQSSS-----
----------#####------TT-------#---------------------------TT-##########---------#####---------#---------TT--------------------#------K--------------------------------T-----TT--TT------------------
---------######------TT-------X---------------------------TT-##########--------######---------#---------TT----TT--------------##--------------------------------------TT----TT---T------------------
--------######-------TT-------SX----------k---------------TT###########-------#######---------#---ggk---TT----TT--------------##---K------K-------k-------K-----------TT--ggTT--TT--------K---------
--XXX----XXXXX---XXXXXXXXXXXXXXXXXXXXXXXXXXXXXXXXXXXXXX---XXXXXXXXXXXXXXXXXXXXXXXXXXX-XXXXXXXXXXX-XXXXXXXXXXXXXXXXXXXXXXXXXXXXXX----XXXXXXXXXXXXXXXXXXXXXXXXXXXXXXXXXXXXXXXXXXXXXXXXXXXXXXXXXXXXX---
--XXX----XXXXX--XXXXXXXXXXXXXXXXXXXXXXXXXXXXXXXXXXXXXXXX--XXXXXXXXXXXXXXXXXXXXXXXXXX--XXXXXXXXXXXXXXXXXXXXXXXXXXXXXXXXXXXXXXXXXX----XXXXXXXXXXXXXXXXXXXXXXXXXXXXXXXXXXXXXXXXXXXXXXXXXXXXXXXXXXXX----