----------------------------------------------------------------------------------------------------------------------------------------------------------------------------------------------------
----------------------------------------------------------------------------------------------------------------------------------------------------------------------------------------------------
----------------------------------------------------------------------------------------------------------------------------------------------------------------------------------------------------
----------------------------------------------------------------------------------------------------------------------------------------------------------------------------------------------------
----------------------------------------------------------------------------------------------------------------------------------------------------------------------------------------------------
------------------#---------------------------------------------------------------------------------------------------k-----k-----------------------------------------------------------------------
----------------###---------------------SSS-------------------------------------SSQSSS--------------------------g----------gSS------------------------------------------------------------S---------
---------------g###--------------------------------##---------------------------------------------------------SS----------gg---g--------------------------------------------------------------------
----------------##-----S-SSS----------------------###----------------------------------------SQS---?SSS-------------------------#----------------SSS------------------------------------------------
---------------###-------------------------------####---------------------------------------------------------------------------#-----------------------kggg----------------------------------------
-------S------####-----------------g#----####---#####----------------T--------SQSSSSSSS--------------------QSSQS-------------####---------SSCSS--------########---##--------------SSCS-SS-----------
-------------#####------------------#-----------#####-----------------T-------------------------#-----#-------------------------#------------K--------####----#---##-----------------K--------------
-------------####---------#---------#-----------#####----------T------TT------------------------------#-----------#-------------#---------------------###-----#---##--------------------------------
------K-----#####---------#---------#----------######---ggk---TT----k-TT--------K---------------------#-----------#-------------#----------K----------###-------#-##---------------K-------------#--
XXXXXXXXXXXXXXXXX---XXXXXXXXXXXXXXXXX---XXXXXXXXXXXXXXXXXXXXXXXXXXXXXXXXXXXXXXXXXXXXXXX---X---XXXXXXXXXXXXXXXXXXXXXX-----------XXXXXXXXXXXXXXXXXXXXXXXXXXX----XXXXXXXXXX-XXX--XXXXXXXXXXXXXXXXXXXXXX
XXXXXXXXXXXXXXXXX---XXXXXXXXXXXXXXXXX---XXXXXXXXXXXXXXXXXXXXXXXXXXXXXXXXXXXXXXXXXXXXXXX---X---XXXXXXXXXXXXXXXXXXXXXX-----------XXXXXXXXXXXXXXXXXXXXXXXXXXX----XXXXXXXXXXXXXX--XXXXXXXXXXXXXXXXXXXXXX