--------------------------------------------------------------------------------------------------------------------------------------------------------------
--------------------------------------------------------------------------------------------------------------------------------------------------------------
--------------------------------------------------------------------------------------------------------------------------------------------------------------
S--SSSSSSSSSSSSSSSSSSSSSSSSSSSSSSSSSSSSSSSSSSSSSSSSSSSSSSSSSSSSSSSSSSSSSSSSSSSSSSSSSSSSSSSSSSSSSSSSSSSSSSSSSSSSSSSSSSSSSSSSSSSSSSSSSSSSSSSSSS-----------------
S-----SSSS--SSSS--------------------------------------------------------------------SSS-----------SS--SS------------------------------------------------------
S-----SSSS--SSSS--------------------------------------------------------------------SSS-----------SS--SS------------------------------------------------------
S-------------------------------------------------------------------------------S-----oSSooS---S--SS------S---------------------------------------------------
S-------------------------------------------------------------------------------SS---------S---S--SS------SS--------------------------------------------------
S-------SS-----S---------------------------------------------------------------SSS----SSSSS----SSSSS------SSS--S----S--------------------S--------------------
S-----o-------SS-------SSS------------------------------------------------------------SSSS-------------SooS-S--SSSS------S------------------------------------
S-----SSSSSSSSSS--SS---SSS----SS----------------------------QQ-----------#-###---------SSS-------------SSS-----SSSSSSSSSSS-------TT-------SSSSSS--------------
S--------------------------------------------------#-#-------------------#-###-#-----------------T-------------------------------TT----------------------g----
S--------------------------------------------------#-#-------------T---#-#-#-#-#----------------TT-------------------------------TT--------------------S------
S------------------------------------------g-----#-#-#-----------g-#---#-#-#-#-#---------g-g----TT---------kkk----kk------g-g----TTT-------------------#------
XXXXXXXXXXXXXXXX--XXXXXXXXXXXXXXXXXXX----XXXXXXXXXXXXXXXXXXXXXXXXXXXXXXXXXXXXXXX---XXXXXXXXXXXXXXXXXXXXXXXXXXXXXXXXXXXXXXXXXXXXXXXXXXXXXXXXXX---XXXXXXXXXXXXXX
XXXXXXXXXXXXXXXX--XXXXXXXXXXXXXXXXXXX----XXXXXXXXXXXXXXXXXXXXXXXXXXXXXXXXXXXXXXX---XXXXXXXXXXXXXXXXXXXXXXXXXXXXXXXXXXXXXXXXXXXXXXXXXXXXXXXXXXX--XXXXXXXXXXXXXX