--------------------------------------------------------------------------------------------------------------------------------------------------------------
--------------------------------------------------------------------------------------------------------------------------------------------------------------
--------------------------------------------------------------------------------------------------------------------------------------------------------------
S----SSSSSSSSSSSSSSS-S---SSSSSS-----------SSSSSSSSSSSSSSSSSSSSSS------SSSSSSSSSSSSSSSSSSSSSSSSSSSSSSSSSSSSSSSSSS---SSSSSSSSSSSSSSSSSS----------SSSSSSSSSS-----
S------------------------------------------------------------------------------------------------SSSSS------SS------------------------------------------------
S------------------------------------------------------------------------------------------------SSSSS--------------------------------------------------------
S--------------------------------S--SSSS---------------------------------------------------------S------------------------------------------------------------
S-----------------------------------S-S---------------------------------------------------------SS-----S------------------------------------------------------
S-----------------------------------SS---------------------------------------------------------SSS---S-SS-----------------------------------------------------
S-------------------------SS--------SS--------------------------------------------------------SSSS---SSSSS----------------------------------------------------
S----g-#-----TT-----TT----SS-----------------------#-#-#--TT--------------T---QQS-----SS-#--SSS-SS---S------------T----#----------SSSS------------------------
S------###-----#----TT---------------------------#-#-#---------T---------T-------------#-#------SS---------------TT----#-------------S------------------------
S----#-###-----#-#-------------------------------#-#-#---------T---------T-------------#--------SS---------------TT--#-#-#---#-##----S------------------------
S----#####-#-###-#-----S---------------------#-#---g-----------T-----------------#-k---#--------S----------g-----T---#-#-##-##-##--#--------------------------
XXXXXXXXXXXXXXXXXXXXXXXX--XX--XX--XXXXXXXXXXXXXXXXXXXXXXXXXXXXXXXXXXXXXXXXXXXXXXXXXXXXXXXXXXXXX-XX--XXXXXXXXXXXXXXXXXXXXXXXXXXXXXXXX----XXXXXXXXXXXXXXXXXXXXXX
XXXXXXXXXXXXXXXXXXXXXXXX--XX--XX--XXXXXXXXXXXXXXXXXXXXXXXXXXXXXXXXXXXXXXXXXXXXXXXXXXXXXXXXXXXXXXXX--XXXXXXXXXXXXXXXXXXXXXXXXXXXXXXXX----XXXXXXXXXXXXXXXXXXXXXX