--------------------------------------------------------------------------------------------------------------------------------------------------------------
--------------------------------------------------------------------------------------------------------------------------------------------------------------
--------------------------------------------------------------------------------------------------------------------------------------------------------------
S--SSSSSSSSSSSSSSSSSS-SSSSSSSSSSSSSSSSSSSSSSSSSSSSSSSSSSSSSSSSSSSSSSSSSSSSSSSSSSSSSSSSSSSSSSSSSSSSSSSSSSSSSSSSSSSSSSSSSSSSSSSSSSSSSSSSSSSSSSSSSSSS------------
S-----SS-----------------------------SSS--SS--------------------------------SSSS---SSS----------------SSS-S---------------------------------------------------
S-----SS-----------------------------SSS--SS--------------------------------SSSS----SS----------------SS----------------------------------------SS------------
S-----SS-----------------------------SSSS-SS--SS-------------------------------------S------------------------------------------------SSSSSSSS--SS------------
S-----S-----------------------------------SS--SS------------------------------------------------------------------------------------------------SS------------
S-----SS-S--------------------------------SS-S-S--S---------------------------------------------------------------------------------------------S---S---------
S-----SS-So-----------------------Sg----SoSS--SS--S-------------------------------------------------SS------------------------------------------SooS----------
S-----SS-SSSS-----------SS--SSSS--SSSSSSSSSS--SSSSSS--------------------TT----SSS-------------------SSS-----------T--------------------g#-------SSSS--SS------
S-----------------------------------------------------------------------TT----------------------------------------TT-----------------------S------------------
S--------------STT----------------------------------------S-------------TT----------------------------------------TT--------SS------------SS------------------
S--------------gST------------------------------------------------------TT-----------------#-----------------g-g--TT--TT-----------g--------------------------
S-XXXXXX--XX--XXXXXXXXXXXXXXXXXXXXXXXXXXX---XXXXXXXXXXXXXXXXXXXXXXXXXXXXXXXXXXXXXXXXXXXXXXXXXXXXXXXXXXXXXXXXXXXXXXXXXXXXXX--XXXXXXXXXXXXXXX-----XX---XXXXX---X
SXXXXXXX--XX--XXXXXXXXXXXXXXXXXXXXXXXXXXXX--XXXXXXXXXXXXXXXXXXXXXXXXXXXXXXXXXXXXXXXXXXXXXXXXXXXXXXXXXXXXXXXXXXXXXXXXXXXXXX--XXXXXXXXXXXXXXX-----XX---XXXXX---X