--------------------------------------------------------------------------------------------------------------------------------------------------------------
--------------------------------------------------------------------------------------------------------------------------------------------------------------
--------------------------------------------------------------------------------------------------------------------------------------------------------------
S--SSSSSSSSSSSSSSSSSSSSSSSSSSSSSSSSSSSSSSSSSSSSSSSSSSSSSSSSSSSSSSSSSSSSSSSSSSSSSSSSSSSSSSSSSSSSSSSSSSSSSSSSSSSSSSSSSSSSSSSSSSSSSSSSSSSSSSSSSSSSSSSSSS---------
S-----SSS---------------------------------------SSSSSSSS----------S---SS--SS-SSSS---------SS---SSS------------------------------------------------------------
S-------SS--------------------------------------SSSSSSS---------SSS---SS--SS-SSSS----------S---SSS------------------------------------------------------------
S-------SS------------------------------------------SS---S----SS------SS-oSS--------ooooo------------SS-------------------------------------------------------
S---------------------------------------------------SS--SS----SS-------S--------------------------------------------------------------------------------------
--------------------------------------------------S--S--SS----SS---SS--S-S-S--SSSSSSSSSSSSS----S----SSSS------------------------------------------------------
------o-------------------------------------------So-S--SS-----S----SooS--SSooSS---S----SS---oSS--------SS----------------------------------------------------
S----SSSSS-------------#-#--##-------#-----------SSSSS--SS-----S-----SSS---SSSSS--------SSSSSSSS--------SSSSQQQQQ-----------SS--------------------------------
S----------------------#----##-------#-----#-------------------S-------------------------------------------------------#--------------------------------------
S--------------------###-#---#-#---#-#-#---#------------------SS----------------------TT---------------------------g-#-#-#-------------------g-#--------------
S--------------------#####-#-#-#-#-###-#---#--kk-----S------------------kk-----g---T--TT------k-------------------S#-#-#-#-----------------#-#-#-------g-g----
XXXXXXXXXX--XXXXXXXXXXXXXXXXXXXXXXXXXXXXXXXXXXXXXXXXXXXXXXXXXXXXXXXXXXXXXXXXXXXXXXXXXXXXXXXXXXXXXXXXXXXXXXXXXXXXXXXXXXXX--XXXXXXXXXXXXXXXXXXXXXXXXXXXXXXXXXXXX
XXXXXXXXXXX-XXXXXXXXXXXXXXXXXXXXXXXXXXXXXXXXXXXXXXXXXXXXXXXXXXXXXXXXXXXXXXXXXXXXXXXXXXXXXXXXXXXXXXXXXXXXXXXXXXXXXXXXXXXX--XXXXXXXXXXXXXXXXXXXXXXXXXXXXXXXXXXXX