--------------------------------------------------------------------------------------------------------------------------------------------------------------
--------------------------------------------------------------------------------------------------------------------------------------------------------------
--------------------------------------------------------------------------------------------------------------------------------------------------------------
S-----SSSSSSSSSSSSSSSSSSSSSSSSSSSSSSSSSSSSSSSSSSSSSSSSSSSSSS--------SSSSSSSSSSSSSSSSSSSSSSSSSSSSSSSSSSSSSSSSSSSSSSSSSSSSSS--------------SSSSSSSSSSSSSSSS------
S---------------SS--------------------------------------------------SSSSSS--SS--SSSS--------------------------------------------------------------------------
S---------------SS--------------------------------------------------SSS-SS--SS--SSSS--------------------------------------------------------------------------
S----------------------------------------------------------------------------------S--S-----------------------------------------------------------------------
S-------------------------------------------------------------------------------------------------------------------------------------------------------------
S-----------------------SS-----S-----------------------------------------SS------------------------------------------------------------------S----------------
S----------------------SSSS--S-So-----------------------------------------S------------------------------------S-----------------------------S----------------
S-------------SSSSSSSSSS--SSSS-SSSSS--------@QQ----------------------------------------------------------S--SSSS----------------TTSS--------------------------
S--------TT--------------------------------------------T-----------------------------------------------------------------S------TT----------------------------
S--------TT-------------------------------------------TT--------------------SSS-----------------------------------------TT------TT----------------------------
S---g-g---T--g---------------k-------------------g----T----g-------g-g-g-----------------g--SS---------g-----------g-g--TT------T--------------------------X--
XXXXXXXXXXXXXXXXXXX----XXXXXXXXXXXXXXXXXXXXXXXXXXXXXXXXXXXXXXXXXXXXXXXXXXX-------XXXXXXXXX--XXXXXXXXXXXXXX--XXXXXXXXXXXXXX--XXXXXXXX--XXXXXXXXXXXXXX--XXXXXXXX
XXXXXXXXXXXXXXXXXXX---XXXXXXXXXXXXXXXXXXXXXXXXXXXXXXXXXXXXXXXXXXXXXXXXXXXX-------XXXXXXXXX--XXXXXXXXXXXXXX--XXXXXXXXXXXXXX--XXXXXXXX--XXXXXXXXXXXXXX--XXXXXXXX