--------------------------------------------------------------------------------------------------------------------------------------------------------------
--------------------------------------------------------------------------------------------------------------------------------------------------------------
--------------------------------------------------------------------------------------------------------------------------------------------------------------
S---SSSSSSSSSSSSSSSSSSSSSSSSSSSSSSSSSSSSSSSSSSSSSSSSSSSSSSSSSSSSSSS------------SSSSSSSSSSSSSSSSSSSSSSSSSSSSSSSSSSSSSSSSSSSSSSSSSSSSSSSSSSSSSSSSSSSSSSSS-------
S----------------------------------------SSSSS--SS------------------------------------------------------------------------------SS--SS------------------------
S-----------------------------------------SSSS--SS------------------------------------------------------------------------------SS--SS-S----------------------
S-----oo-------------------SoooSSS----------SS-SSS---------------------------------ooo----------------------------------------------S--S----------------------
S-------------------------------------------SSSS-S----------------------------------------------------------------------------------SS-SSS--------------------
S----SSSS------------------SSSSS------SS----SS-------------------------------------SSS-------------------------------------------SSSS--S----------------------
S---------------------SS----SSSS------SS----SS-------------------------------------SSSS-----------------------------------------o--S------og----------SS------
S---------------------SSSS--SS--------SS----SS----------------------SSQQQQ------------SS----@Q------TT-----------------g##-----SSSSS------SSS---------SS------
S----------------------------------------------------------#-#--------------------------------------TT-----------------###------------------------------------
S----------T-----------------------------------------------#-#-----------------#-----------------------------------g-######-S--------g-#-#--------------------
S---------TT---------------g---------------------------g-#-#---S-------------#-#-----------------#-#-#-g-----------#-#-####----------#-#-#-------g------------
XXXXXXXXXXXXXXXXXXXXXXXXXXXXXXXXXXXXXXXX--XXXXXXXXXXXXXXXXXX--XX--XXXXXXXXXXXXXXXXXX--XXXXXXXXXXXXXXXXXXXXXXXXXXXXXXXXXXXXX------XXX--XXXXXXXXXXXXXXXXXXXXXXXX
XXXXXXXXXXXXXXXXXXXXXXXXXXXXXXXXXXXXXXXX--XXXXXXXXXXXXXXXXXX--XX--XXXXXXXXXXXXXXXXXX--XXXXXXXXXXXXXXXXXXXXXXXXXXXXXXXXXXXXX------XXX--XXXXXXXXXXXXXXXXXXXXXXXX