--------------------------------------------------------------------------------------------------------------------------------------------------------------
--------------------------------------------------------------------------------------------------------------------------------------------------------------
--------------------------------------------------------------------------------------------------------------------------------------------------------------
S--SSSSSSSSSSSSSSSSSSSSSSSSSSSSSS------SSSSSSSSSSSSSSSSSSSSSSSSSSSSSSSSSSSSSSSSSSSSSSSSSSSSSSSSSSSSSSSSSSSSSSSSSSSSS----SSSSSSSSSSSSSSSSSSSSSSSSSS------------
S------S-----SSSSSSSSS--SS------------------------------------------------SS--------------------SS--------------------------SSSS--SS--------------------------
S------S-----SSSS-SSSS--SS------------------------------------------------SS--------------------SS---------------------------S----SS--------------------------
S------------SS----SSS--SS-Soo------------------oo-----------------------SSS--Soooo-----------------------------------------------S---------------------------
S---------------------------------------------------------------------SS--SS------------------------------------------------------SS--------------------------
S---------------------------SSS-----SS---------SSSSSSS----------------SS--SS-S-SSSSS--SS-----------------------------------------SSS--------------------------
S----S----------------------SSS-----SS---S--SoSS--SSSS--------------------SS-SSSSS--SSSS-----S-----------------ooS----------SS--SSSS--------------------------
S---SS------------SS-----------------SSSSSSSSSSS---------@QQQ-------------SS----SS--SSSS--SSSS--SSSSSSSSS----SSSSS------QQQ-SS-------@QQQ--------#-#---#------
S------------------------------------------------#-#---------------#---------------------------------------------------------------------------#---#-#-#-#----
S----------#-#-#--TT-----S-----------------------#-#-#-----------#-#-------------------------------------------------------------------------S-#---#-#-#-#----
S-----g-g--S-#-#--TT-g-----------------------g-#-#-#-#-g---------#-#-----------------------------------g---S------kk---------g-----------g--g------#-#-#-#----
XXXXXXXXXXXXXXXXXXXXXXXXXX--XXXXXXXXXXXXXXXXXXXXXXXXXXXXXXXXXXXX-XXX----XXXXXXXXXXXXXXXXXXXXXXXXXXXXXXXX--XXXXXXXXXXXXXXXXXXXXXXXXXXXXXXXXXXXXXXXXXXXXXXXXXXXX
XXXXXXXXXXXXXXXXXXXXXXXXXX--XXXXXXXXXXXXXXXXXXXXXXXXXXXXXXXXXXXX-XXX---XXXXXXXXXXXXXXXXXXXXXXXXXXXXXXXXX--XXXXXXXXXXXXXXXXXXXXXXXXXXXXXXXXXXXXXXXXXXXXXXXXXXXX