--------------------------------------------------------------------------------------------------------------------------------------------------------------
--------------------------------------------------------------------------------------------------------------------------------------------------------------
--------------------------------------------------------------------------------------------------------------------------------------------------------------
S-SSSSSSSS-------SSSSSSSSSSSSSSSSSSSSSSSSSSSSSSSSSSSSSSSSSSSSSSSSSSSSSSSSSSSSSSSSSSSSSSSSSSSSSSSSSSSSSSSSSSSSSSSSSSSSSSSSSSSSSSSSSSSSSSSSSSSSSSSSSSSSSS-------
S---SSSS------------------------------------------------------------SSS---SSSSS-------------------------------SS-SSSSSSSSSSS----------------SS--S-------------
S---SSSS------------------------------------------------------------SSS---SSSSS-------------------------------SS--SSSSSSSSSS----------------SS----------------
S---SS----------------SSSS-----------------------oo------------------S-SooS---S--------------------------Soo-SSS-----------Soooo--o---------SS--SS-oSSSS------
S---SS-----------------------------------SSC-C-----------------------S--------S-------------------------------S-----------------------------SS---S---S-S------
S---SS-----------------------------------SSSSS--SS-S-----------------S-SSSS---S--------------------------SSSSSS----------SSSSSSS--SS--------SS---S-SS---------
S---SS------------------------------------SSSS--SoSS---------------ooS---SSS--SS---S------------------------SoS-----So--SS--SSSSS-S---------SS-SSSSSSS--------
S---SSS-------------------SS----SSS--------SSS--SSSSQQQ----#--S---SSSS---SSSSSSS---S--SSSSSS--SSS---QQ------SSSS----SSSSSS-----SSS---S------SS--SSS-----------
S----------------T-----------------------#-S---------------#-#----------------------------------------------------------------------TT------------------------
S----------------T---------------------g-#-#-------------#-#-#----------------------------------------------------------------------TT---#-#-#-#--------------
S-----------g-g--T-------------------#-#-#-#--kk---------#-#-#-----------------g-g--------------------------k--------g--------------TT---#-#-#-#--------------
XXXXXXXXXXXXXXXXXXXX----XXXXXXXXXXXXXXXXXXXXXXXXXXXXXXXXXXXXXXXXXXXX----XXXXXXXXXXXX--XXX-XXXXXXXXXXXXXXXXXXXXXXXXXXXXXXXXXXXXXXXXXXXXXXXXXXXXXXXXX--XXXXXXXXX
XXXXXXXXXXXXXXXXXXXX---XXXXXXXXXXXXXXXXXXXXXXXXXXXXXXXXXXXXXXXXXXXXX----XXXXXXXXXXXX--XXXXXXXXXXXXXXXXXXXXXXXXXXXXXXXXXXXXXXXXXXXXXXXXXXXXXXXXXXXXXX-XXXXXXXXX