--------------------------------------------------------------------------------------------------------------------------------------------------------------
--------------------------------------------------------------------------------------------------------------------------------------------------------------
--------------------------------------------------------------------------------------------------------------------------------------------------------------
S-SSSSSSSSSSSSSSSSSSSSSSSSSSSSSSSSS-SSSSSSSSS-SSSSSSSSSSSSSSSSSSSSSSSSSSSSSSSSSSSSSSS-----------SSSSSSSSSSSSSSS---------SSSSSSSSSSSSSSSSSSSSSSSSSSSSSSSS------
S---------------------SSSSSS------------------------SSSSSS----------------------------------------------------------------------------------------------------
S---------------------SSS-SS------------------------SSSSS-----------------------------------------------------------------------------------------------------
S-----------------------------SS-----------------------------------------o-----------------------------S--oooo------------------------------------------------
S------------------------------------------------------------------------------------------------------S------------------------------------------------------
S---SSS------------------------------------------------------------------S----------------------------SSSSSSSS-------------------------------------SS---------
S---SS-------------------------------------------------------------------------------------------------S-SSSSS----------------------------------oooS----------
S-------------------------SS------------QQQ----------#-------------#-----#---------------------------SSS---SSS--------------------------------SSSSSS----------
S-------------------T------------------------------#-#-------------#-#---#-#--------------------------SS------------------------------------------------------
S------------------------------------------------#-#-#-S-----------#-#-#-#-#-S-------------#-----#----SS-------------------T----------------------------------
S--------------g----TT------kS-------------------#-###---------g---#-#-#---#-S-------------#--#--#-------------------g-g---T-------g----------------kk-g-g--XX
XXXXXXXXXXXXXXXXXXXXXXXXXXXXX----X---X--XXXXXXXXXXXXXX---XXXXXXXXXXXXXXX-------XXXXXXXXXXXXXXXXXXXXXXXXXXX--X--XXXXXXXXXXXXXXXXXXXXXXXXXXXXXXXXXXXXXXXXXXXXXXX
XXXXXXXXXXXXXXXXXXXXXXXXXXXXX----X---X--XXXXXXXXXXXXXX--XXXXXXXXXXXXXXXX-------XXXXXXXXXXXXXXXXXXXXXXXXXXX--X--XXXXXXXXXXXXXXXXXXXXXXXXXXXXXXXXXXXXXXXXXXXXXXX