--------------------------------------------------------------------------------------------------------------------------------------------------------------
--------------------------------------------------------------------------------------------------------------------------------------------------------------
--------------------------------------------------------------------------------------------------------------------------------------------------------------
S-----SSSSSSSSSSSSSSSSSSSSSSSSSSSSSSSSSSSSSSSSSSSSSSSSSSSSSSSSSSSSSSSSSSSSSSSSSSSSSSSSSSSSSSSSSS----------SSSSSSSSSSSSSSSSSSSSSSSSSSSSSSSSSSSSSSSSSSSS--------
S--------------------------------------------------SSSSS--SSS---------------------------SS---SSS----------------S---------------------------------------------
S--------------------------------------------------SSSS---SSS---------------------------SS----SS----------------SS--------------------------------------------
S----------------oooo------------------------------S--------SS---------------------S----SSS---------------------SS--------------------------------------------
S-------------------------------------------------SS--------SS--------------------------------------------------SS--------------------------------------------
------------S-SS--SSSS----------------------------SS-------------------------------------------------------SSS---SSS------------------------------------------
------------ooSS--SSS-----------------------------SS--------oo----------------------------------------------SS---S--------------------------------------------
------------SSS-----TT-------#----###----SSSSS----SS--------SS-----------------SS----------------------------S---S----S---------------------------------------
--------------------TT-------#------#-#---------------------SS----------------------------------TT-------#-#-S---------------#-#--------TT--------------------
S-------------------TT-----#-#------#-#------------S--------SS---------------------------T------TT-----#-#####-----------g-#-#-#--------TT----------------TT--
----SS--------------TT--g#-#------#-#-#-------------------kk-----------------------------T-g-g--TT---#-#-#####-----------#-#-#-#---g----------------------TT--
XXXXXX------XX--XXXXXXXXXXXXXXXXXXXXXXXXXXXXXXXXXXXXXXXXXXXXXXXXXXXXXXXXXXXXXXXXXXXXXXXXXXXXXXXXXXXXXXXXXXXXXX--XXXXXXXXXXXXXXXXXXXXXXXXXXXXXXXXXXXXXXXXXXXXXX
XXXXXX------XX--XXXXXXXXXXXXXXXXXXXXXXXXXXXXXXXXXXXXXXXXXXXXXXXXXXXXXXXXXXXXXXXXXXXXXXXXXXXXXXXXXXXXXXXXXXXXXX--XXXXXXXXXXXXXXXXXXXXXXXXXXXXXXXXXXXXXXXXXXXXXX