------------------------------------------------------------------------------------------------------------------------------------------------------
------------------------------------------------------------------------------------------------------------------------------------------------------
------------------------------------------------------------------------------------------------------------------------------------------------------
------------------------------------------------------------------------------------------------------------------------------------------------------
-------------------------------------------------------------------------------------------------------g-g--------------------------------------------
----------------------------------------------------------o----%%%%---------------------------------%%%%%%----oo--------------oo----------------------
------SSSSS--------------------------------%%-------------------||------------S---------S-------------|||---------------------------------------------
-----------------%%%%----------------------||-------------------||------oo----------oo----------------|||----------SSSS-------------------------------
----------------||||--------------------------------------------||-----------------------------------||||---------------------------------------------
---------------|||||-----------------%%%%%-----------------------|------------------------------------|||---------------------------------------------
-----%%%%%%--%-|||||------------------|||||%%%%------------%%%%-SSSSS------S---------------#-------%%%%%%%%%%--------------%%%%----------SS--%%%------
------||||----||||||------------------||||||||--------------||-----------------------------#--------||--||||---------%%%%---||----------------|-------
------||||----||||||-----------%%%%---||||||||--------------||----------------------------##--------||--||||----------||----||----------------|-------
------||||----||||||------------||----||||||||------%%%%----||----------------------------###----%%-||--||||----------||----||----------------|--%----
------||||----||||||---XXXXXXX--||----||||||||------%%------||---%%%%%%%%%%%%%%%%%--XXXXXXXXXX----|-||--||||-%%%%%%---||---%||------%-%%%%--%%||-|----
------||||----||||||---XXXXXXX--||----||||||||------||------||-------%%%%%%|---||---XXXXXXXXXXX---||||--||||---|%|----||--|-||------|---|---|||-|-----