------------------------------------------------------------------------------------------------------------------------------------------------------
------------------------------------------------------------------------------------------------------------------------------------------------------
------------------------------------------------------------------------------------------------------------------------------------------------------
------------------------------------------------------------------------------------------------------------------------------------------------------
------------------------------------------------------------------------------------------------------------------------------------------------------
--------oo---------o--o-------------------------oo-------o----or------oo--------------------------o---------------------------------------------------
------------------------------------------S----------------%%%%%-----%%%-----------------------------g----------------------------------------SSSS----
----------------------------------||------oS----------oo----|||-------|----------------------------%%%%------------------------------#----------------
---------------%---%%%%--SSS%%%%--||------------------------|||------||-----S-----------------------||------------------------%%--S###----------------
--------------------||-------|||--||------------------------|||------||-----------------------------||------oo-----------------|---####---||----------
-------------%%%----|--------#|---||---------------------%%%%%%%%--%%%%%--------------------%%%---SS||-------------------------|--#######-||----------
--------------||----||-------###--||----------------------||||||----||||---------SS-----------------||-------------------------#-########-||----------
--------------||------------####--||----------------------||||||----||||----------------------------||-----------%%---------------#######-||----------
--------------||-----------#####--||----------------------||||||----||||----------------------------||%--------%%%-------------#--#######-||----------
------%%%%%%%-||-----XXXXXXXX-||--||---%%%%---%%%%%%%%%%--||||||----||||---%%-------%%----%%%%-----%%|----------||----%%%-XXXXXXXXXXXXXXX-||----%%%---
-------|||%|--||------XXXXXXXX||--||--||-|----||||--%%|---||||||----||||--------------------|-------||----------||-----|%-XXXXXXXXXXXXXXXX||----------