------------------------------------------------------------------------------------------------------------------------------------------------------
------------------------------------------------------------------------------------------------------------------------------------------------------
------------------------------------------------------------------------------------------------------------------------------------------------------
------------------------------------------------------------------------------------------------------------------------------------------------------
-----------------------------------g------------------------------------------------------------------------------------------------------------------
-------------------------------ooo-%------------------------------oo----------oo-------------------%%%%%%%-----%%%%-----------------------------------
---------------------%%%%-----%%%%%%%--------------------------S--S---------------------------------||----------||-------SSSSSSSSSSS------------------
----------------------||-------|||||----------------------------------------------------oo----------||----------||------------------------------------
-----------------%----||-------|||||---------------%%%%%%%%-------------------------%%%%%%----------||----------||------------------------------------
-------#-------|||----||-------|||||-%%%%%%%--------||-|%%----------------------------||------------||-----------|---------o--------------------------
------##-------|||-%--||------%|||||-||||||%%-------||-|||-%%%%--------------%%-------||--------%%%%||------SSSSSS------%%%%%----%%%%-----------------
-----#-#------||||----||------||||||||||||||--------||||||--||----------------||------||--------||||||------------------||||------||------------------
-------#------||||----||------||||||||||||||--------||||||--||-----------%%%%-||------||--------||||||------------------||||------||------------------
-----###-%%%%-||||----||------||||||||||||||--------||||||--||-------------|-|||----%-||--------||||||----%o------------||||------||------|--------#--
XXXXXXXXX-||--||||-----|------||||||||||||||--------||||||--||--%%%%-------|-|||------||--XXXXX-||||||-----------%%%%%%-||||---%%-||---XX-|-----XXXXXX
XXXXXXXXXX||--||||-----|-|----||||||||||||||--------||||||--||---||--------|-|||------||--X-X-%-|-||||------------||%%--|-||------||---XXX|-----|XXXXX