------------------------------------------------------------------------------------------------------------------------------------------------------
------------------------------------------------------------------------------------------------------------------------------------------------------
------------------------------------------------------------------------------------------------------------------------------------------------------
------------------------------------------------------------------------------------------------------------------------------------------------------
------------------------------------------------------------------------------------------------------------------------------------------------------
---------%%%%---oo---------------------------------------------------oo-------------------------------------------------------oo----------------------
----------||------------------------%%%%%%%--------------#SSSSS-------------------------SS--------------------------------------------------%S--------
-----------|-------------------------|-|||---------------#-----------------ooo----------------------------------------oo------------------------------
----------||-------SSSSSSSS----------|||||-------SSS---###---------#----------------------------------------------------------------------------------
-----------|-------------------------|||||-|%----------####--------##---------------------------------------------------------%%%%--------------------
---%%%%----|-----------------SSS--%%%%||||||---------######------####----------S--------------------------------%%%-----------|-||--------S%%%%%%-----
----||------------------------------||||||||---------######-----#####----------------------------------%%%%------|------------||-|----------||||------
----||------------------------------||||||||---------######----######----------------------%%%%---------||-------|------------||-|----------||||------
----||--------|------%%%%-----------||||||||----------#####----#######----------------------||---%%%%---||-------|---%%%%-----||||----------||||--o#--
XXXX||---%%%%%%-------||------------||||||||---XXXXXXXXXXXXXXXXXXXXXXXXXX------%--------%---||----||----||-------|----||------||------%%----||||---%--
XXXX||------|||-------||------------||||||||---XXXXXXXXXXXXXXXXXXXXXXXXXXX------------------||----||----||-------|----||------||------------||||------