------------------------------------------------------------------------------------------------------------------------------------------------------
------------------------------------------------------------------------------------------------------------------------------------------------------
------------------------------------------------------------------------------------------------------------------------------------------------------
------------------------------------------------------------------------------------------------------------------------------------------------------
------------------------------------------------------------------------------------------------------------------------------------------------------
--------------------------------------------o-------------oo----------------------------------------------------oo----------------------oo------------
-----------%%g-------------------##--------------------------------------SSS-------------------------------------%SS----------------------------------
----------%|%%%------------------##-------------------------------------------------------------------------------------------------------------------
-----------|||----------------S####------------------S%-----------------------SSSS-------------------------S-------------------------%%%%%%-----------
-----------|||-----------------####------------------------------------------------S-------------------------%%%%----------------#----||||------------
------%%----||--------%%%-----#####-----%%%%%%-------------------------------------------%%%%------%%%--------||-%%%%------------#----||||-%--SS------
----------|-||--------||------#####------|||||%%%---------|o------------------------------||-------||---------||--||-------------#----||||-|----------
----------|-||||------||------#####-------||||||------------------------------------------||--------|---------||--||-----------####---||||||----------
----------||||||------||------#####-------||||||---------%--------------------------------||--%%%---%%%%%-----||---------------####---||||||----------
X%--------||||||------||XXXXXXXXXXXXXXX---||||||--XXXXX-||--------XXXXXXXXXXXXXXXXX-------||--||----||||------||------XXXXXXXXXXX-|---||||||----------
|---------||||||------||--XXXXXXXXXXXXX---||||||--XXXXX-||--------XXXXXXXXXXXXXXXXXX------||--||----||||------||------XXXXXXXXXXXX||--||||||----------