------------------------------------------------------------------------------------------------------------------------------------------------------
------------------------------------------------------------------------------------------------------------------------------------------------------
------------------------------------------------------------------------------------------------------------------------------------------------------
------------------------------------------------------------------------------------------------------------------------------------------------------
-----------------------------------------------------S------------------------------------------------------------------------------------------------
------------------------o--------------o-----%%%%-----oo-----------------%%%%-------------------------------------------------------------------------
-----------------------------------------------|--------------SSS---------|%%---------###S------------------------------------------------SSSS--------
-----------------------------------------------|--------------------------||----------##-----------------------o--------------------------------------
---------------------------------------------%%%%%------------------------||%%------####--------------------------------------------------------------
--------oo------------------------------------|||-------------------------||||-----#####--oooo------------%%%--------------%%%%%%--------%%%%o--------
----------------------------------------------|||----------------------%%-||||----######-%%%%%%%%%%--%%%%-||-----%%%%%%%----|||||%%---%%--||----------
----------------------------------------------|||---------------oooo----||||||----######--||||---------|--||------||||------||||||-----|--||----------
----------------------------------------------|||--------------%%%%%%---||||||----#####---||||--------|---||------||||------||||||----||--||----------
------------------ooo---------%%%--------------||---------------||||----||||||----######--||||------%%||--||----|-||||-%----||||||----||--||-------#--
X%-------%%%-----%%%%----%%%%-||------%%%%------|XXXXXXXXXXXXXX-||||----||||||--XXXXXXXX--||||--------|---||----||||||------||||||----||--||----%XXXXX
|-----|--||-------||----------||------||X|------|XXXXXXXXXXXXXX-||||----||||||--XXXXX|-X--||||------|-----||----|||||||-----||||||----||--||----|XXXXX