------------------------------------------------------------------------------------------------------------------------------------------------------
------------------------------------------------------------------------------------------------------------------------------------------------------
------------------------------------------------------------------------------------------------------------------------------------------------------
------------------------------------------------------------------------------------------------------------------------------------------------------
-------------------------------------------------------------------------------------------------------------------------##---------------------------
------oo-----%oo%-------------------------oo--------------------------oo----------------------------o--------------------##------------ooo------------
--------------|------------------------------------------------------------------------------%%%%%%%%%%-------SSS%%%%--####---------------------------
--------------------------------oo----------------------------SS------o-----------------------||||||||------------||----#-#---------------------------
--------------|-----------S-------------------------------------------------------------------||||||||------------||----|-----------------------------
----oo-------------------------------------------------------------------------%%%%-----------||||||||------------||---oooo---------------------------
-------------------------------------%%%%%%--------%%%%-------------------------||-----%%%%---||||||||------%---S%%%%%%%%%%----%%%%%%%---------%%%%---
--------------------------------------||||----------||--------------------------||------||----||||||||-------%----||||||||------||||------------||----
--------------------------------------||||----------||--------------------------||------||----||||||||------||-----|||||||-----|||||------------||----
-----------------------------%%%------||||---%%%%%%-||--------------------------||---o--||-%%%%%||||||-------------|||||||-----|||||------------||----
XXXXXXXXXXXXXXXXX%%%----%%----||----||||||----||-|--||---XXX--------%%%%%%----%-||XXX%%-||---||-||||||--%%%%%%%%----||||||-----|||||-----%%%----||----
XXXXXXXXXXXXX--XX-|-----||----||----||||||----||-|--||--X-----------|-|||-----X-||X-XX--||---||-||||||------||------||||||-----|||||------|-----||----