------------------------------------------------------------------------------------------------------------------------------------------------------
------------------------------------------------------------------------------------------------------------------------------------------------------
------------------------------------------------------------------------------------------------------------------------------------------------------
------------------------------------------------------------------------------------------------------------------------------------------------------
------------------------------------------------------------------------------------------------------------------------------------------------------
------------------oo--------------------------------ooor------------------------------------------------------------oo--------------------------------
------------------------------S%-------------------%%%%%%---------------------------------SSS---------------SSS----------------######-----------------
----------------------------------------------------||||--------o-----------------oo--oo---------------------------------------######-----------------
----------------------------------------------------||||---------------------------------------------------------------------########--------%%%%-----
----------------------------------------------------||||-----------------SSS-------------------------------------------------########-----%%%|||%%%---
----------%%%%----------%%%%%-%------------%%%%-----||||-%%%%----------------------------------------------%%%-----%%%-%%%%-#########-%%%%----||||----
-----------||------------|||----------------||------||||---------%-o%---------------------------------------|-------||--||--#######----|||----||||----
------------|-------------||----------------||------||||---------|-#----------------------------------------|-------||--||---#####----||||----||||----
-----------------%%%%-----||--%%%%%---------||----o-|||||||------||#----------------------------------------|-------||--||---#####----||||----||||----
X%%%%%---%%%------||------||---|||--------%-||----%-|||||||----%%%||--XXXXXXXX--------XXXXXXXXXXX---------%%%%%%--%-||--||--XXXXXX----||||----||||---X
----|-----|-------||------||----||----------||----|-|||||-|-----||||--XXXXXXX---------XXXXXXXXXXX----------|||------||--||--XXXXXX----||||------||---X