------------------------------------------------------------------------------------------------------------------------------------------------------
------------------------------------------------------------------------------------------------------------------------------------------------------
------------------------------------------------------------------------------------------------------------------------------------------------------
------------------------------------------------------------------------------------------------------------------------------------------------------
--------------------------o----------------------------g----------------------------------------------------------------------------------------------
-------------------------XXX-------%%%%%%----------%%%%%----ooXoo---------------------------oo----------------------------oooo------------------------
---------------%%%------------------||||-------g-----||--S-%%%%%---------------------------------------------------------%%%%%%-----------------------
----------------SSS-------SS--------||||---%%%%%%----||-----|||-----------------------------------------------------------||||------------------------
------------------------------------||||----||||-----|||----||||-------------------------------------SS------%%%%---------||||------------------------
-------------#----------------------||||----||||-----|||----||----------%%-----%%%%%%----------------SSS------||----------||||------------------------
-------------#-------------------#--||||----||||-----%%%%%%-||----%%----|%%%%---||||--%%----------------------||----------||||------------------------
-------------#---------#---------##-||||----||||------||-----|----------||-|----|||||-|--------------------#--||----------||||------------------------
-------------#-------------------#--||||----||||------||----------------||||----|||||-|------------------###--||-%--------||||------------------------
-------------#------------------##--||||----||||------||----------------||||-%%-|||||-|-------------------##--||----------||||---------------------#--
XXXXXXXXXXXXXXXXXXXXXXXXXXXXXXXXXXX-||||----||||-%%%%-||-----X--%%%%----||||-|--|||||||----%%%%-XXXXXXXXXXXXX-||----------||||----%%%%%%XXXXXXXXXXXXXX
-XXXXXXXXXXXXXXXXXXXXXXXXXXXXXXXXXX-||||----||||--||--||----X----|||----||||-|--||||||------||--XXXXXXXXXXXXX-||----------||||-----%%%|-XXXXXXXXXXXXXX