------------------------------------------------------------------------------------------------------------------------------------------------------
------------------------------------------------------------------------------------------------------------------------------------------------------
------------------------------------------------------------------------------------------------------------------------------------------------------
------------------------------------------------------------------------------------------------------------------------------------------------------
---------------------------###------------------------------------------------------------------------------------------------------------------------
---------------------------###------------oo----------oo-----------------------------oor------------------------------------------Xoo-----------------
------------------------######-##---------%---S----------------------------------%%%%%%%%----------------------------------%%%%%%---------------------
------------------------######-##---------|----SSS-------------------------------%||||||------------------------------------||||----------------------
---------------SSS------####---##---------|----------------------------%%%%%------||||||-----------------------%%%%---------||||--------------S-------
------------------------####--###---------|-----------------------------|||-------||||||---%-%%----o------------||----------||||----------------------
------------------------##----###---------|-------SSSSSS---------####---|||-------||||||----||------------------||----------||||----------------%%%%%-
-------------------------#----##------------------------oo-------##-----||--------||||||----||------------------||----------||||-----------------|||--
-------------------------#-----#-------------------------------####-----||--------||||||----||------------S-----||----------||||---------%%%----||||--
-------------------------#-----#---%%%%------------------------#####----||--------||||||----||------------------||----------||||----------|-----||||--
XXXXXXXX---------XXXXXXXXXXXXXXXXXX-||--------%%%%--------XXXXXXXXXXXX--||---%----||||||--XXXXXXXXXXXXXX------%%%%%%%%%%----||||----------|-----||||--
XXXXXXXXX-|------|-XXXXXXXXXXXXXXXXX||---------||---------XXXXXXXXXXXX--||--------||||||--XXXXXXXXXXXXXX------||||---||-----||||----------|-----||||--