------------------------------------------------------------------------------------------------------------------------------------------------------------------------------------------------------------------------------
------------------------------------------------------------------------------------------------------------------------------------------------------------------------------------------------------------------------------
------------------------------------------------------------------------------------------------------------------------------------------------------------------------------------------------------------------------------
------------------------------------------------------------------------------------------------------------------------------------------------------------------------------------------------------------------------------
------------------------------------------------------------------------------------------------------------------------------------------------------------------------------------------------------------------------------
---------------------------------------------------------------------------------------------------------------------------------------------------------------------------------------------------#--------------------------
--------------------Q-----------------------------------------------------------------------------------------------------------------------------------------------------------------------------##-------Q------------------
--------------------------------------------------------------------------------------------------oooo-------------------------------------------------------------------------------------------###--------------------------
------------------------------------------------------------------------------------------------------------------------------------------------------------------------------------------------#####-------------------------
------------oooo--------------------------------------------------#----------------------------------------------------------------------------------------------------------------------------######--------o----------------
-----------------------Q-Q--Q-------------------------------------#---------------------------------------------------------------------TT-------------------------Q-Q-------------QQ---------#######-------------------------
--------------------------------------------------------TT-------###--------------------------------------------------------------------TT---------------------------------------------------#########------------------------
-----------TT-------------------------------------------TT------#-##--------------------------------------------------------------------TT--------------------------------------------------##########------------------------
-----------T---------------y--------------------#-------TT-----##-###----------------y--------#--------------------------------y--------TT-----y----------#--------------y-----y-----y---y--##########------------------------
XXXXXXXXXXXXXXXXXXXXXXXXXXXXXXX---XXX---XXXXXXXXXXXXXXXXXXXXXXXXXXXXXXXXXXXXXXXXXXXXXXXXXXXXXXX--XXXXXXX--XXXXXXXXXXXXXXXXXXXXXXXXXX-XXXXXXXXXXXXXXXXXXXXXXXXXXXXXXXXXXXXXXXXXXXXXXXXXXXXXXXXXXXXXXXXXXXXXXXXXXXXXXXXXXXXX--XX
XXXXXXXXXXXXXXXXXXXXXXXXXXXXXXX---XXX---XXX-XXXXXXXXXXXXXXXXXXXXXXXXXXXXXXXXXXXXXXXXXXXXXXXXXXXX-XXXXXXX--XXXXXXXXXXXXXXXXXXXXXXXXXX--XXXXXXXXXXXXXXXXXXXXXXXXXXXXXXXXXXXXXXXXXXXXXXXXXXXXXXXXXXXXXXXXXXXXXXXXXXXXXXXXXXXX--XX