------------------------------------------------------------------------------------------------------------------------------------------------------------------------------------------------------------------------------
------------------------------------------------------------------------------------------------------------------------------------------------------------------------------------------------------------------------------
------------------------------------------------------------------------------------------------------------------------------------------------------------------------------------------------------------------------------
------------------------------------oo----------------------------------------------------------------------------------------------------------------------------------------------------------------------------------------
------------------------------------------------------------------------------------------------------------------------------------------------------------------------------------------------------------------------------
------------------------------------------------------------------------------------------------------------------------------------------------------------------------------------------------------------------------------
-------------------------------------------------------------------------------------------------------------------------------------------------------------------Q-Q--------------------------------------------------------
-------------------------------------#-----ooo-------ooo------------------------------oooo---------------oooo-----------------------o-o--------------------------------------------------------------oo-----------------------
-------------------------------------#---------------------------------------------------------------------------------------------------Q------------------------------------------------------------------------------------
-------------------------------------#------------------------------------------------------------y---------------------------------------------------------------------------------------------------------------------------
--QQQQ------Q---------Q--------ooo---#--#---------TT----------------------Q----------TT----------------------------------o--------------------------------------------Q----------------------oTT--------------TT--------------
---------------------------------#-###--#---------TT---------------------------------TT-----------------------------------------#---#---------------------------------------------------------TT--------------TT--------------
---------------------------------#--##------------TT---------------------------------TT-----------------------------------------#---------------T---------------------------------------------T---------------TT--------------
-----y-----------y---------------#---#---------y--TT-----------------------------------------------------------y----------------#---------------T----------------------------y------T----y----TT-----------y--TT--------------
XXXXXXXXXXXXXXXXXXXXXXXXXXXXXXXXXXXX--XXXXXXXXXXXXXXXXXXXXXXXXXXXXXXXXXXXXXXXXXXXXXXXXXXXXXXXXXXXXXXXXXXXXXXXXXXXXXXXXXXXXXXXXXXXXXXXXXXXXXXXXXXXXXXXXXXXXXXXXXX----XXXXXXXXXXXXXXXXXXXXXXXXXXXXXXXXXXXXXXXXXXXXXXXXXXXXXXXXXX
XXXXXXXXXXXXXXXXXXXXXXXXXXXXXXXXXXXXX-XXXXXXXXXXXXXXXXXXXXXXXXXXXXXXXXXXXXXXXXXXXXXXXXXXXXXXXXXXXXXXXXXXXXXXXXXXXXXXXXXXXXXXXXXXXXXXXXXXXXXXXXXXXXXXXXXXXXXXXXXX----XXXXXXXXXXXXXXXXXXXXXXXXXXXXXXXXXXXXXXXXXXXXXXXXXXXXXXXXXX