------------------------------------------------------------------------------------------------------------------------------------------------------------------------------------------------------------------------------
------------------------------------------------------------------------------------------------------------------------------------------------------------------------------------------------------------------------------
------------------------------------------------------------------------------------------------------------------------------------------------------------------------------------------------------------------------------
------------------------------------------------------------------------------------------------------------------------------------------------------------------------------------------------------------------------------
------------------------------------------------------------------------------------------------------------------------------------------------------------------------------------------------------------------------------
------------------------------------------------------------------------------------------------------------------------------------------------------------------------------------------------------------------------------
--------------------------Q-----------------------------------------------------------------------------------------------------------------------------------------------------------------------------#---------------------
------------------------------------------------------------------------------------------------------------------------------#----------o-----------------##-----ooo---------------------------------------------------------
-----------------------------------------------------###---Q-Q------------------------Q------1------------------------------------------------------------###---------------------------Q-------------------------------------
--------------------------------------------------y-####-------------------------------------------------------------------------------------------------####-----------------------------------------------------------------
-------------------------QQQ------------------------###--------------QQ-----------------------------------TT---------------------------QQQQ---Q----------####---TT--------------------------------------------Q-Q-------------
--------------------------------------------------######--------------------------------------------------TT--------------#-----------------------------#####---TT----------------------------------TT------------------------
----------------------------------------------#--#######----------TT----------------#-------------------------------------#----------------------------######---TT----------------------------------TT------------------------
-----------------y-----------y---------y------#--#######----------TT----------------#------------y------------------------#---------------------------#######---TT-----------------------y----------TT------------------------
XXXX--XXXXXXXXXXXXXXXXXXXXXXXXXXXXXXXXXXXXXXXXXXXXXXXXXXXXXXXXXXXXXXXXXXXXXXXXXXXXXXXXXXXXXXXXXXXXXXXX--XX--XXXXXXXXXXXXXXXXXXXXXXXX--XXXXXXXXXXXXXXXXXXXX-XXXXXXXXXXXXXXXXXXXXX-XXX----XXXX--XX--XXXXXXXX--XX--XXXXXXXXXXXXXX
XXXX--XXXXXXXXXXXXXXXXXXXXXXXXXXXXXXXXXXXXXXXXXXXXXXXXXXXXXXXXXXXXXXXXXXXXXXXXXXXXXXXXXXXXXXXXXXXXXXXX--XX--XXXXXXXXXXXXXXXXXXXXXXXXXXXXXXXXXXXXXXXXXXXXXXXXXXXXXXXXXXXXXXXXXXXX--XX----XXXX--XX--XXXXXXXX--XX--XXXXXXXXXXXXXX