------------------------------------------------------------------------------------------------------------------------------------------------------------------------------------------------------------------------------
------------------------------------------------------------------------------------------------------------------------------------------------------------------------------------------------------------------------------
------------------------------------------------------------------------------------------------------------------------------------------------------------------------------------------------------------------------------
------------------------------------------------------------------------------------------------------------------------------------------------------------------------------------------------------------------------------
------------------------------------------------------------------------------------------------------------------------------------------------------------------------------------------------------------------------------
----------------------------------------##------------------------------------------------------------------------------------------------------------------------------------------------------------------------------------
---------------------------------------###---------------------------------------Q-Q------------------------------------------------------------------------------------------------------------------------------------------
----------------------------oooo-----#####------------------------------------------------------------------------o-----------------------------------------------------------------------------------------------------------
------------------------------------#######-----------------------------------------------------------------------------------------------------------------------------------------------------------------------------------
-----------------------------------########-----------------------------------------------------------------------------------------------------------------------------------------------------------------------------------
-------o-----------------oo--------########---------------------------------------QQ--------------------------------------------------------------------------------------------Q---------------------------------------------
----------------------------------#########-----------------------------------------------------------------------------------------------------------------------------------------------------------------------------------
----------------------------------########--------TT--------------------------------------------------------TT------------------------------------------------------------------------------------TT---------------------T----
---------------y--------TT--------#########-------TT-----------------------y-----------y--------------------TT-------------------y----------------------------------------------------------------TT---------------------T----
XXXXXXXXXXXXXXXXXXXXXXXXXXXXXXXXXXXXXXXXXXXXXXXXXXXXXXXXXX--XXX---XX--XXXXXXXXXXXXXXXXXXXXXXXX----XXXX--XXXXXXXXXXXXXX--XXXXXXXXXXXXXXXXXXXXXXXXX---XX--XXXXX-XXXXXXXXXXXXXXXXXXXXXXXXXXXXXXXXXX--XXXXXXXXXXX-------XXXXXXXXXX
XXXXXXXXXXXXXXXXXXXXXXXXXXXXXXXXXXXXXXXXXXXXXXXXXXXXXXXXXX--XXX---XX--XXXXXXXXXXXXXXXXXXXXXXXX----XXXX--XXXXXXXXXXXXXX--XXXXXXXXXXXXXXXXXXXXXXXXX---XX--XXXXX-XXXXXXXXXXXXXXXXXXXXXXXXXXXXXXXXXX--XXXXXXXXXXX-------XXXXXXXXXX