------------------------------------------------------------------------------------------------------------------------------------------------------------------------------------------------------------------------------
------------------------------------------------------------------------------------------------------------------------------------------------------------------------------------------------------------------------------
------------------------------------------------------------------------------------------------------------------------------------------------------------------------------------------------------------------------------
------------------------------------------------------------------------------------------------------------------------------------------------------------------------------------------------------------------------------
------------------------------------------------------------------------------------------------------------------------------------------------------------------------------------------------------------------------------
------------------------------------------------------------------------------------------------------------------------------------------------------------------------------------------------------------------------------
------------------------------------------------------------------------------------------------------------------------------------------------------------Q-Q---------------------------------------------------------------
--------oooo---------------------------oooo-------------------------------------------ooo-----------------------------------------------------------------------------oo------------------------------------------------------
------------------------------------------------------Q-----------------------------------------------------------Q-----------------------------------------------------------------------------------------------------------
-------------------------------------------------------------------------------------------o--------------------------------------ooo-----------------------------------------------------------------------------------------
------------------------------------------------------------------------------------TT------------------------------------------------------------------------Q--------------------------------------------Q----Q-------------
------------------------------------------------------------------------------------TT----------------------------------------TT----------------------------------------------------------------------------------------------
----------------------------------------------------TT------------------------------TT----------------------------------------TT--------#-------------------------------------------#-----------------------------------------
-------------y------------------------#-------------TT-------y----------------------TT-------------------y--------------------TT----#---#-------X----------------------------y--#---#--------y--------------------------------
XXXXXXXXXXXXXXXXXXXXXXXXXXXXXXXXXXXXXXXXXXXXXXXXXXXXXXXXXXXXXXXXXXXXXXXXXXXX--XXXXXXXXXXXXXXXXXXXXXXXXXXXXXXXXXXXXXXXXXXXXXXXXXXXXXXXXXXXXXXXXXXXXXXXXXXXXXXXXXXXXXXXXXXXXXXXXXXXXXXXXXXXXXXXXXXXXXXXXXXXXXXXXXXXXXXXXXXXXXXXX
XXXXXXXXXXXXXXXXXXXXXXXXXXXXXXXXXXXXXXXXXXXXXXXXXXXXXXXXXXXXXXXXXXXXXXXXXXXX--XXXXXXXXXXXXXXXXXXXXXXXXXXXXXXXXXXXXXXXXXXXXXXXXXXXXXXXXXXXXXXXXXXXXXXXXXXXXXXXXXXXXXXXXXXXXXXXXXXXXXXXXXXXXXXXXXXXXXXXXXXXXXXXXXXXXXXXXXXXXXXXX