------------------------------------------------------------------------------------------------------------------------------------------------------------------------------------------------------------------------------
------------------------------------------------------------------------------------------------------------------------------------------------------------------------------------------------------------------------------
------------------------------------------------------------------------------------------------------------------------------------------------------------------------------------------------------------------------------
------------------------------------------------------------------------------------------------------------------------------------------------------------------------------------------------------------------------------
------------------------------------------------------------------------------------------------------------------------------------------------------------------------------------------------------------------------------
------------------------------------------------------------------------------------------------------------------------------------------------------------------------------------------------------------------------------
------------------------------------------------------------------------------------------------------------------------------------------------------------------------------Q-----------------------------------------------
--------------------------------------------------------------------------oo--------------------------------------ooooo----------------------------------###--------oo--------------------------------------------------------
--------------------------------------------------------------------------------------------------------------------------------------------------------##-##---------------------------------------------------------Q-------
---------------------------------y--------------------------------------------------------------------------------#----------------y-------------------######---------------------------------------------------#-------------
-------------------T----------Q?S-QQ------------------------------------TT---------------------------------------##--------------?SQQ-----------------#######-----------------QQ----------T-----------Q-----------------------
------------------T---------------------TT------------------------------TT---------------------------------------#------------------------------------#-######----------------------------TT----------------------------------
------------------TT--------------------TT------------------------------TT-------------------------------------###----------------------#------------########X----------------------------TT------------------X---------------
------------------T---------------------TT--------------------------y---T------------y-----------------y------###-----------------------#-----------#-#####-XX-------y-------------------TT-------------------XX--------------
XXXXXX--XXXXXXXXXXXXXXXXXXXXXXX-XXXXXXXXXXXXXXXXXXXXXX--XX--XXXXXXXXXXXXXXXXXXXXXXXXXXXXXXXXXXXXXXXXXXXXXXXXXXXXXX-XXXXXXXXXXXXXXXXXXXXXXXXXXXXXXXXXXXXXXXXXXXXXXXXXXXXXXXXXXXXXXXXXXXXXXXXXXXXXXXXXXX--XXXXXXXXXXXXXXXXXXX---
XXXXXXX-XXXXXXXXXXXXXXXXXXXXXXX-XXXXXXXXXXXXXXXXXXXXXX--XX--XXXXXXXXXXXXXXXXXXXXXXXXXXXXXXXXXXXXXXXXXXXXXXXXXXXXXX-XXXXXXXXXXXXXXXXXXXXXXXXXXXXXXXXXXXXXXXXXXXXXXXXXXXXXXXXXXXXXXXXXXXXXXXXXXXXXXXXXXX--XXXXXXXXXXXXXXXXXXX---