------------------------------------------------------------------------------------------------------------------------------------------------------------------------------------------------------------------------------
------------------------------------------------------------------------------------------------------------------------------------------------------------------------------------------------------------------------------
------------------------------------------------------------------------------------------------------------------------------------------------------------------------------------------------------------------------------
------------------------------------------------------------------------------------------------------------------------------------------------------------------------------------------------------------------------------
------------------------------------------------------------------------------------------------------------------------------------------------------------------------------------------------------------------------------
------------------------------------------------------------------------------------------------------------------------------------------------------------------------------------------------------------------------------
----------------------------Q---------------------------------Q--------------------------------------------------------------------------------------------------------------------------------------QQQ--Q-------------------
----oo---------------------------------------------------------------------------------------------------------------------------------------------------------------------------------#--------------------------------------
--------------------------------------------------------------------------------------------------------------------------------------------------------------------------------------##--------------------------------------
------------------------------------------------------------------------------------------------------------------------------------------------------------------------------------y###-------------y------------------------
-----------TT--------------QQQ------------------------------------------------------------------------------------Q---------TT--------------------------Q---------------------------####----------Q?SSQQQ---Q----------T------
-----------TT-------------------------------#-------------TT----------------------------------------------------------------TT-----------------------------------------------------#####-------------------------------T------
-----------TT-------------------------------#---#---------TT----------------------------------------------------------------TT------------------------------------#-#--------------#####-------------------------------TT-----
-----------TT------------------y------------#--------y----TT-----------------------------y-------------------------y---y----TT-----y---------------y----------------#-----------#--#####---y---------------y---y---y---TT-----
XXXXXXX---XXXXXXXXXXXXXXXXXXXXXXXXXXXXXXXXXXXXXXXXXXXXXXXXXXXXXXXXXXXXXXXXXXXXXXXXXXXXXXXXXXXXXXXXXXXXXXXXXXXXXXXXXXXXXXXXXXXXXXXXXXXXXXXXXXXXXXXXXXXXXXXXXXXXXXXXXXX--XXXXXXXXXXXXXXXXXXXXXXXXXXXXXXXXXXXXXXXXXXXXXXXXXXXXXXX
XXXXXXX---XXXXXXXXXXXXXXXXXXXXXXXXXXXXXXXXXXXXXXXXXXXXXXXXXXXXXXXXXXXXXXXXXXXXXXXXXXXXXXXXXXXXXXXXXXXXXXXXXXXXXXXXXXXXXXXXXXXXXXXXXXXXXXXXXXXXXXXXXXXXXXXXXXXXXXXXXXXX-XXXXXXXXXXXXXXXXXXXXXXXXXXXXXXXXXXXXXXXXXXXXXXXXXXXXXXX