------------------------------------------------------------------------------------------------------------------------------------------------------------------------------------------------------------------------------
------------------------------------------------------------------------------------------------------------------------------------------------------------------------------------------------------------------------------
------------------------------------------------------------------------------------------------------------------------------------------------------------------------------------------------------------------------------
------------------------------------------------------------------------------------------------------------------------------------------------------------------------------------------------------------------------------
------------------------------------------------------------------------------------------------------------------------------------------------------------------------------------------------------------------------------
------------------------------------------------------------------------------------------------------------------------------------------------------------------------------------------------------------------------------
------------------------------------------------------------------------------------------------------------------------------------------------------------------------------------------------------------------------------
--------------------------oooo--------------------------------------------------------------------------------------oo-----------oooo-------------------oo--------------------------------------------------------------------
-----------------------------------------------------------------------------------------------------------------------------------------------------------------------------------------o------------------------------------
------------------------------------------------------------------------------------------------------------------------------------------------------------------------------------------------------------------------------
---------------------ooTT--------------------QQQ-------------------------------o---------------------------------o-----------Q----------------------------------Q-Q---Q-------------TT----------------------------------------
-----------o------------T----------------------------------------------------------------------#------------------------------------------------------------------------------------TT----------------------------------------
-----------------------TT-----------------TT------------------------------TT-------------------#--------------------------------------------------------------------------TT--------TT----------------------------------------
-----y-----------------TT-----------------TT---y--------------------------TT-------------------#----------------TT---------------------------------y-------y--------------TT---------T-------------------------------------y--
XXXXXXXXXX--------XXXXXXXXXXXXXXX---XXXXXXXXXXXXXXXXXX--XXXXXXXX--XXXXXXXXXXXXXXXXXXXXXXXXXXXXXXXXXXXXXXXXXXXXXXXXXXXXXXXXXXXXXXXXXXXXXXXXXXXXXXXXXXXXXXXXXXXXXXXXXXXXXXXXXXXX--XXX-XXXXXXXXX-XXXXXXXXXXXXXXXXXXXXXXXXXXXXXXXX
XXXXXXXXXX--------XXXXXXXXXXXXXXX---XXXXXXXXXXXXXXXXXX--XXXXXXXX---XXXXXXXXXXXXXXXXXXXXXXXXXXXXXXXXXXXXXXXXXXXXXXXXXXXXXXXXXXXXXXXXXXXXXXXXXXXXXXXXXXXXXXXXXXXXXXXXXXXXXXXXXXX--XXX-XXXXXXXXX-XXXXXXXXXXXXXXXXXXXXXXXXXXXXXXXX