------------------------------------------------------------------------------------------------------------------------------------------------------------------------------------------------------------------------------
------------------------------------------------------------------------------------------------------------------------------------------------------------------------------------------------------------------------------
------------------------------------------------------------------------------------------------------------------------------------------------------------------------------------------------------------------------------
------------------------------------------------------------------------------------------------------------------------------------------------------------------------------------------------------------------------------
------------------------------------------------------------------------------------------------------------------------------------------------------------------------------------------------------------------------------
------------------------------------------------------------------------------------------------------------------------------------------------------------------------------------------------------------------------------
--------------------------------------------------------------------------------Q---------------------------------------------------------------------------------------------------------------------------------------------
--------------oo--------------------------------------o---------------------------------------------------------------------------------------------oo------------------------------------------------------------------------
----------------------------------------------------#-------------------------------------------------------------------------------------------------------------------------------------------------------------------------
---------------------------------------------------##--------------------------y----------------------------------------------------------------------------------------------------------------------------------------------
----------TT--------------------------------------#--#-----------------------?SSQQQ-------------------------------------------------T---------------------------------Q--------------------Q--------Q-------------------------
----------TT--------------------------#---------######------------------------------------------------------------------------------------------------------------------------------------------------------------------------
----------TT--------------------------#---------######------------------------------------------------------------------------------T-------------------------T---------------------------------------------------------------
-----y----TT--y-----------------------#----y---#######---------------------------------------------------------y-------------------TT------------------y-------y--------------------------------------------------------------
XXXXXXXXXXXXXXXXXXXXXXXXXXXXXXXXXXXXXXX--XXXXXXXXXXXXXXXXXXX--XX--XXX-XXXXXXXXXXXXXXXXXX--XXXXXXXXXXXXXX--XXXXXXXXXX--XXXXXXXXXXXXXXXXXXXXXXXXXXXXXXXXXXXXXXXXXXXXXXXXXXXXXXXXXXXXXXXXXXXXXXXXXXXXXXXXXXXXXXXXXXXXXXXXXXXXXXXX
XXXXXXXXXXXXXXXXXXXXXXXXXXXXXXXXXXXXXXX--XXXXXXXXXXXXXXXXXXX--XX--XXX-XXXXXXXXXXXXXXXXXX--XXXXXXXXXXXXXX--XXXXXXXXXX--XXXXXXXXXXXXXXXXXXXXXXXXXXXXXXXXXXXXXXXXXXXXXXXXXXXXXXXXXXXXXXXXXXXXXXXXXXXXXXXXXXXXXXXXXXXXXXXXXXXXXXXX