-------------------------------------------------------------------------------------------------------------------------------------------------------------------------------------------
-------------------------------------------------------------------------------------------------------------------------------------------------------------------------------------------
-------------------------------------------------------------------------------------------------------------------------------------------------------------------------------------------
S--S-SSSSSSS----------SSSSSSSSSSSS----SSSSSSSSSSSSSSSSSSSSSSSSSSSSSSSSSSSSSSSSSSSSSSSSSS-SSSSSSSSSSSSSSSSSSSSSSSSSSSSSSSSSSSSSSSSSSSSSSSSSSSSSSSSSSSSSSSSSSSSSSSSSSSSSSSSSSSSSSSSSSSSSSSSSS
S-----------------------------------------------------S----SSSS--------------------------SSSSSSSSSSSSSSSSSSSSSSSSSSSSSSSSS-----------------------------------------------------------------
S----------------------------------------S-----------S------SSSS-------------------------SSSSSSSSSSSSSSSSSSSSSSSSSSSSSSSSS-----------------------------------------------------------------
S---------------------------------------SS----------------------------------------------SSSSSSSSSSSSSSSSSSSS-SSSSSSSSSSSS------------------------------------------------------------SSSSSS
S----------------------------------------------------------------------------------------------------------------------------------------------------------------------------------------SS
S-------------------------------SS-----------S---------------------------------------------------------------------------------------------------------------------------------------------
S-----------------------------------------------------------------------TT--------------oooo-----------------------------------------------------------------------------------------------
S--------QQQ------SS-------------#------SSS-SS-SS-S-----SSSSSSS---------TT--------------SSSSSSSSSSSSSSS-QQ----SSSSS--------------------SSS-TT------------------T---------------S------SSSSS
S-------------------------------##----------SSSS---S---------SS---TT----TT-----------------SSSSSSSSSSSS---------------#--------------------TT--tS--------------TT--TT---#------------------
S-------------------------------------------SSSS------------SSSS--TT----TT-----------T-----SSSSSSSSSSSS------#-------##--------------------TT--S---#------S----T---TT--##------------------
S------------------------------------------------k----------------TT----TT---------------kSSSSSSSSSSSSS-------------###--------------------TT------#-----XS----T---TT--##------------------
XXXXXX--XXXXXXXXXXXXXX---XXXXX--------XXX-XXX-XXXXXXX-XXXXXXXXXXXXXXXXXXXX--------XXX---XXXXXXXXXXXXXXXXXXXXXXXXXXXXXXXXX---XXX----XXXXXXXXXXXXXXXXXXXX-XXX--XXXXXXXXXXXXXX--XXXXXXXXXXXX--
XXXXXX--XXXXXXXXXXXXXX---XXX----------XXX-XX--XXXXXXX-XXXXXXXXXXXXXXXXXXXX--------XXX---XXXXXXXXXXXXXXXXXXXXXXXXXXXXXXXXX----XX----XXXXXXXXXXXXXXXXXXXX--XX--XXXXXXXXXXXXX---XXXXXXXXXXXX--