-------------------------------------------------------------------------------------------------------------------------------------------------------------------------------------------
S------------------------------------------------------------------------------------------------------------------------------------------------------------------------------------------
-------------------------------------------------------------------------------------------------------------------------------------------------------------------------------------------
S--------SSSSSSSSSSSSSSSSSSSSSSSSSSSSSSSSSSSSSSSSSSSSSSSSSSSSSSSSSSS-------SSSSSSS-------SSSSSSSSSSSSS---SSSSSSSSSSSSSSSSSSSSSSSSSSSSS---SSSSSSSSSSSSSSSSSSSSSSSSSSSSSSSSSSSSSSSSSSSSSSSSSS
S--------------------------------------------------------------------------------------------------------------------------------------------------SSSSSSS---------------------------------
S------------------------------------------------------------------------------------------------------------------------------------------------S-SSSSSSS---------------------------------
S-------------------------------QQ---------SS----------------------------------------SS-SS-------------------------------------------------------SSSSSSSS------------SS------S-------SS----
-------------------------------------------------S-----------------------------------------------------------------------------------------------------------------------------------------
S------------------------------------------SS--------------------------------------S---------------------------------------------------------------------S-----------------S-----S---------
S----------------------------------------------------------------------------------------------------T-------------------------------------------------------------------------------------
S-------TT----------TT--SSSSSSSSSSSS----------SS----------QQ------TT---TTT--QQQQ-----------------SS-TT--TT--------QQ----------------SSSSSS---SS--------------------T-SSS---T------SSSSSSSSS
S-------TT---#------TT--SSSSSSSSS---------------------TT----------TT--T-TT--------------------ST----TT--TT----------------------------------------------------S----TT------TT---------SSSSS
S-------TT--##------TT--SSSSSSS-----------------------Tt-------t--TT----TT--------------------------TT--TT---t------#--------------------S--------#----------#t----TT------TT---t-----SSSSS
S------kTT---#-----kTT--SSSSSSS------------------------t------St--TT----TT-------------------------kTT--TT--kt---k-##----------------------------##-----------#----TT------TT--tt----kSS-SS
XXXXXXXXXX--XXXXXXXXXXXXXXXXXXXXXXXXX----XXX--XXXXXX--XXXXXXXXXXXXXXXXXXXX-XXXXX-----XXXXXXXXXXXXXXXXXXXXXXXXXXXXXXXX--------X---XXXXXXXXXXXXXXXXXX--XXXXXXXXXXXX--XXXXXX--XXXXXX-XXXXXX-XX
XXXXXXXXXX--XXXXXXXXXXXXXXXXXXXXXXXXX----XXX--XXXXXX---XXXXXXXXXXXXXXXXXXX-XXXXX-----XXXXXXXXXXXXXXXXXXXXXXXXXXXXXXXX--------X---XXXXXXXXXXXXXXXXXX--XXXXXXXXXXX---XX--X---XXXXXX-XXXXXX-XX