-------------------------------------------------------------------------------------------------------------------------------------------------------------------------------------------
-------------------------------------------------------------------------------------------------------------------------------------------------------------------------------------------
-------------------------------------------------------------------------------------------------------------------------------------------------------------------------------------------
S-----------SSSSSSSSSSSSSSSSSSSSSSSSSSSSSSSSSSS-SSSSSSSSSSSSSSSSSSSSSSSSSSSSSSSSSSSSSSSSSSSSSSSSSSSSSSSSSSSSSSSSSSSSSSSSSSSSSSSSSSSSS----SSSSSSSSSSSSSSSSSS---SSSSSSSSSSSSSSSSSSSSSSSSSSSSS
S-------------SSSSSSSSSSSSSSSSSSS--------------------------SSSSSSSSSSSSS--------------------------------------SSSS--------------------------SSSSSSSSSSSSSSS--------------------------------
S-------------SSSSSSSSSSSSSSSSSSS--------------------------SSSSSSSSSSSS-----------------------------------------SS---------------------------SSSSSSSSSSSSSS--------------------------------
S--------------SSSSSSSSSSSSSSSSS-------------------------------SSSSSSS---------------------------------------------------S------S-------SSSSSSSSSSSSSSSSSSS-SSSS---------------------SS----
S---------------------------------------------------------------------------------------------------------------------------------------S--------------------------------------------------
S-----------------------------------------------------------------------------------------------------------------------------------SSSS---------------------------------------------------
S-------------------------------------------------------------------------------------------------------------------------------------------------oooooooooS-------------------------------
S--------------------------S-------Q----------------------------SS-------S---------------------TT------------S-----Q--SSSSSSSSSSSSSSS------------SSSSSSSSSSSSSSS-----TT--SS----------------
S-----------------------------TT------------T---------------------------S---#------------------T------------------------SSSSSSSS-----------------------SSSSSSS-------TT---S-----##---##----
S-----------------------------TT------------TT--#S---------##--------#S-S--##--------t---t-----T-----T------------------SSSSS-SS-----------------------SSSSSSS-tt----TT---S-S--##S---##--SS
S-----------------------k----k-T-----------kTT---T--------##--------##S---###--------t---t---k-------------------------kSSSSS-ST----------------------SSSSSSS---t----TT--------##----##--SS
XXXXXX-------XXXXXXXXXXXXXXXXXXXXXXXXXXXXXXXXXXXXXXXXXXXXXXXXXXXXXXXXXXXXXXXXX---XXXXXXXXXXXXXXXXXXXXXXXXXXXXXXX----XXXXXXXXXXXXX--XX------XXXXXXXXXXXXXXXXXXXXXXXXXXX-XXXX----XXXXXXXX--X-
XXXXXX-------XXXXXXXXXXXXXXXXXXXXXXXXXXXXXXXXXXXXXXXXXXXXXXXXXXXXXXXXXXXXXXXXX---XXXXXXXXXXXXXXXXXXXXXXXXXXXXXXX----XXXXXXXXXXXXX--XX-------XXXXXXXXXXXXXXXXXXXXXXXX---XXXX----XXXXXXXX--X-