-------------------------------------------------------------------------------------------------------------------------------------------------------------------------------------------
-------------------------------------------------------------------------------------------------------------------------------------------------------------------------------------------
S------------------------------------------------------------------------------------------------------------------------------------------------------------------------------------------
S-----SSSSSSS---SSSSSSSSSSSSSSSSSSSSSSSSSSSSSSSSSSSSSSSSSSSSSSSSSSSSSSSSSSSSSSSSSSSSSSSSSSSSSSSSSSSSSSSSSSSSSSSSSSSSS-------------SSSSSSSSSSSSSSSS----SSSSSSSSSSSSSSSSSSSSSS---SSSSSSSSSSSS
S--------------------------------------------SSSSSSSSSSSSSSSS------------------------------------SSSSSSSSSSSSS---------------------SSSSSSSSSSSS---------------------------------SS---------
S--------------------------------------------SSSSSSSSSSSSSSSS------------------------------------SSSSSSSSSSSSS---------------------S-SSSSS-S-S-----------------------------------SS--------
S--------SS----------------------------------SSSSSSSSSSSSSSSS-----SSSSSSS----------------------SSSSSSSSSSSSSS----------------SS------S-----------------------------------------------------
S------------------------------------------------------------------------------------------------------------------------------------------------------------------------------------------
S------S---------------------------------------------------------------------------------------------------------T-------------------------------------------------------------SSS-SS------
S---------------------------T------------------ooooooooooo---------------ooo------------------------------------TT---------------------------TT--------------------------------------------
S--SS-----------------------TT----SS----------SSSSSSSSSSSSS-SS----------SSSSST-------S--SS-------S--------------TT-----------S----SSSSSS-----TT----Q-------------Q---QQ--------------------
SS-SS-----------TT----------TT------------------------------TT---#----------TT--------------------S--------T----TT------TT--------SSSSSS-----TT--------------------------------------------
SSSSSSSS--------TT----------TT---#--------------------------TT--##---#------TT------------------SSSSSSS---------TT---#--TT------SSSSSSSS-----TT--------------------------------------------
SSSSS----------k-------t---kTT---#----------------------SS--TT---#---------kTT-------k----------SSS------------kTT---#-kTT-----t-----SSS---k-TT----##------------------------k-----------SS
XXXXXXXXXXXXXXXXXXXXXXXXXXXXXXXXXXX----XXXXXXXXXXXXXXXXXXXXXXX---XX-XXXXXXXXXXX--XXXXXX-XXXXXXXXXXX-XXXXXXXXXXXXXXX-XXXXXXXXXXXXX--XXXXXXXXXXXXXXXXXX--------XXXXXXXXXXXXXXXXXXXX---X----SS
XXXXXXXXXXXXXXXXXXXXXXXXXXXXXXXXXXX------XXXXXXXXXXXXXXXXXXXXXX--XX-XXXXXXXXXXX--XXXXXX-XXXXXXXXXX--XXXXXXXXXXXXXXXXXXXXXXXXXXXXX--XXXXXXXXXXXXXXXXXX--------XXXXXXXXXXXX--XXXXXX---X----XS