-------------------------------------------------------------------------------------------------------------------------------------------------------------------------------------------
-------------------------------------------------------------------------------------------------------------------------------------------------------------------------------------------
-------------------------------------------------------------------------------------------------------------------------------------------------------------------------------------------
S--SSSSSSSSSSSSSSSSSSSSSSSSSSSSSSSSSSSSSSSSSSSSSSS-------SSSSSSSSSSSSSSSSSSSSSSSSSSSSSSSS-------SSSSSSSSSSSSSSSSSSSSSSSSSSSSSSSSSSSSSSSSSSSSSSSSSSSSSSSS------SSSSSSSSSSSSSSSSSSSSSSSSSSSSS
S--SSSSSSSSSSSSSS----SSSSSSSSSSSSS---------------------------------------------------------------------------SSSSSSSSSSSSSSS-----------------------S---------------------------------------
S--SSSSSSSSSSSSSS-----SSSSSSSSSSSS---------------------------------------------------------------------------SSSSSSSSSSSSSSS-----------------------SSS-------------------------------------
S--SSSSSSSSSSSSSS-----SSSSSSSSSSS---------------------------------------------------------------------------SSSSSSSSSSSSSSSS-------------------------------------------------------------SS
S----------------------------------------------------------------------------------------------------------------------------------------------------------------------------------------SS
S--------------------SSSSS-S--------------------------SS----SS-----------------------S-----------------------------------------------------------------------------------------------------
S------------------------------------------------------------------------------------------------------------------------------------------------------------------------------------------
S-SSSSSSSSSSSSS----------------S-------------------SS---QQ-------------------------------------SS--------TSS--SSSSSSSSSSSSSS-------------------SSSSSS--S-------------------------TT-------S
SSSSSSSSSSSSSSS-----------------------------------------------------------------------------------------TT----SSSSSSSSSSSS-------------##--TS-SSSSSSS-------TT-------------------TT------SS
S--SSSSSSSSSSSS--#--------------------------------------------------------------------------------------TT----SSSSSSSSSSSS---------T--###--T--SSSSSSS-------TT-----t---------T---TT------SS
S---SSSSSSSSSSSk-#-----------------------------------------------------t---------------------------t---kTT----SSSSSSSSSSS----------T--###--TS-SSSSSSS------kTT----S----------T--kTT------SS
XXXXXXXXXXXXXXXXXX-----------XXXXXXXXXXXXXX--------------------XXXXXXXXXXX-------XXXX--XXXXXXXXXXXXXXXXXXXXXXXXXXXXXXXXXXXXXXXXXXXXXXXXXX--XXXXXXXXXXXXXXXXXXXXXXXXXXXXXXXXXXXXXXXXXXXX--XX
XXXXXXXXXXXXXXXXXX-----------XXXXXXXXXXXXXX--------------------XXXXXXXXXXX-------XXXX--XXXXXXXXXXXXXXXXXXXXXXXXXXXXXXXXXXXXXXXXXXXXXXXXXX--XXXXXXXXXXXXXXXXXXXXXXXXXXXXXXXXXXXXXXXXXXXXXXXX