-------------------------------------------------------------------------------------------------------------------------------------------------------------------------------------------
S------------------------------------------------------------------------------------------------------------------------------------------------------------------------------------------
S------------------------------------------------------------------------------------------------------------------------------------------------------------------------------------------
S-SS----SSSSSSSSS--------------------SSSSSSSSSSSSSSSSSSSSSSSSSSSSSS--S------SSSSS----SSSSSS------SSS-SSSSSSSS----SSSSSSSSSSS----SSSSSSSS-----SSSSSSSSSSSSSSSSSSSSSSSSSSSSSSSSSSSS---------S
S-----------------------------------------SSSSSSSSSS----------------------------------SSSS-----------------------------S-S--------------------SSSSSSSSSSSS-------------SSSSSSSSSS----------
S-----------------------------------------SSSSSSSSSS------------------------------------SS-----------------------------SSS--------------------SSSSSSSSSSSS-------------SSSSSSSSS-----------
S----------------------------------------SSSSSSSSSSSSSSS--------------------------------------------------------------SSSS------------------SQSSSSSSSSS-S-SSS----------SSSSSSSS------------
S-----------------------------------------------------------------------------------------------------TT------------------------------------------SS-S-------------------------------------
S----------------------------------------------------------------------------SSS----------------TT----TT---S-----------------------------------------------------------------------------SS
S-----------------------------------------------------------------------------------------------TT----TT-----------------------T---------------------------------------------------------SS
S----T--QQ--------T---------------------SSSSSSSSSSSSSSS--#------------------------------SS--QQ--TT--SSTTSUS--------------------TSSS--T-----------SSSSSSSSSSS----SSS------SSS-SSSSSSSSS---S-
S---TT------------TT------------S-----TT-SSSSSSSSSSSSSS-S#--TT----------------------------------TT----TT-----T-----------#-----T----#T----------SSSSSSSSSS-----TT----TT----T--S-SS---T-----
S----T------------TT------------------TT-SSSSSSSSSSSSSSSS#--TT----------------------------------TT----TT----T------------#S----TT---TT----------SSSSSSSSStt----TT----TT----T---------TT----
S----T------------TT-----------------kTT-SSSSSSSSSSSSSSSS#--TT----------------------------------TT---kTT---k-------------------T---#TT----------SSSSSSSSSSt----TT---kTT---kT---k-----TT--S-
XXXXXXXXXXXXXXXXXXXX----XXXXXXXXXXXXXXXXXXXXXXXXXXXXXXXXXXXXXXXXXXXXXXXXX-------XXXXXXXXXXXXXXX--XXXXXXXXXXXX----XXXXXXXXXXXX-XXXXXXXXX----XXXXXXXXXXXXXXXXXXXXXXXXXXXXXXXXXXXXXXXXXXXX----
XXXXXXXXXXXXXXXXXXXX----XXXXXXXXXXXXXXXXXXXXXXXXXXXXXXXXXXXXXXXXXXXXXXXXX--------XXXXXXXXXXXXXX--XXXXXXXXXXX-----XXXXXXXXXXXX-XXXXXXXXX-----XXXXXXXXXXXXXXXXXXXXXXXXXXXXXXXXXXXXXXXXXXX----