-------------------------------------------------------------------------------------------------------------------------------------------------------------------------------------------
-------------------------------------------------------------------------------------------------------------------------------------------------------------------------------------------
-------------------------------------------------------------------------------------------------------------------------------------------------------------------------------------------
S--SSSS-----SSSSSSSSSSSSSSSSSSSSSSSSSSSSSSSSSSSSSSSSSS---SSSSSSSSSS-------SSSSSSSSSSSSSSS--S-------SSSSSSSSSS--SSSSSSSSSSSSSSSSSSSSSSSSSSSSSSSSSSSSSSSSSSSSSSSSSS-----SSSSSSSSSSSSSSSSSSSSS
S------------------------SSSSSSSSSSSSSSS-----------------SSS-----------------------------------------------------SSSSS-------------------------SSSS-----------------------------SSSSSSSSSSS
S------------------------SSSSSSSSSSSSSSS-----------------S---------------T---------------------------------------SSSS--------------------------SSSS-----------------------------SSSSSSSSSS-
S--------------------------SSSSSSSSSSSSS---------------------------------T--------------------SSSSSSSSS-----------SSSS-------------------------SSSS----------------------------SSSSSSSSSSSS
S------------------------------------------------------------------------T-----------------------------------------------------------------------------------------------------------------
S---------------------------SS---------------------SS--------------------------------------------------------------------------------------------------------------------------------------
S----------------------------------------------------oooooooo----------S-------------------------------------------------------------------------------------------------------------------
S--------------------------------SSSSSSS------------SSSSSSSSS-----------------------------SS-----------------------SSSSSSSSS------------SSS------------------------------------SSSSSSSSSSSS
S---------------------------------SSSSSS-----------------------#---------------------------S-------#----------------SSSSSSSS-----------------------------------------------TT----------SSSS
S-----S----------------------------SSSSS-------#----T---------##---------------------------S---t---#----------------SSSSSSSS-----------------------------------##----------TT----------S-SS
S---------TT------------------------SS--------##----TT---k---k-#------------------------------S----##---------------SSSSSSSS---------------------------t---#---##---------kTT----------S-SS
XXXXXXX---XX--XX----X-XX----XXXXXXXXXXXXXXXXXXXXXXX---XXXXXXXXXXX------X---XXXXXXXX-XXXXXXXXXXXXX-XXX--XX--XXXXXXXXXXXXXXXXXXXXXXXXXXXXXXXX----XXXXXXXXXXXXXXXXXX---X--XXXXXXXXXXXXXXXXX-X-
XXXXXXXX--XX--XX-------X----XXXXXXXXXXXXXXXXXXXXXXX----XXXXXXXXXX----------XXXXXXXX-XXXXXXXXXXXXX-XXX--XX--XXXXXXXXXXXXXXXXXXXXXXXXXXXXXXXX----XXXXXXXXXXXXXXXXXX---X--XXXXXXXXXXXXXXXXX-X-