-------------------------------------------------------------------------------------------------------------------------------------------------------------------------------------------
-------------------------------------------------------------------------------------------------------------------------------------------------------------------------------------------
-------------------------------------------------------------------------------------------------------------------------------------------------------------------------------------------
S-SSSSSSSSSSSSSSSSSSSSSSSSSSSS------SSSSSSSSSSSSSSSSSS------SSSSSSSSSSSSSSSSSSSSSSSSSSSSSSSSSSS-SSSSSSS----SSSSSSSSSSSSSS----------SSSSSSSSSSSSSSSSSSSSSSSSSSSSSSSSSSSSSSSSSSSSSSSSSSSSSSSS
S------------SSSS------------------------------------------------------------------------------------------------------------------------------------------------------------SSSSSSSSSSSSS-
S------------SSSS------------------------------------------------------------------------------------------------------------------------------------------------------------SSSSSSSSSSS---
-----------------------------------------------------------------------------------------------------------------------------------------------------------------------------SSSSSSSSS-----
-------------------------------------------------------------------------------------------------------------------------------------------------------------------------------------------
----------------------------------------------------SS------------------------------------------------------------------------------------------------------------------------------------S
------------------------------------------------------------------------------------------------------------------------------------------------------------------------------------------S
S--------------SSSSSSSST-------------------------------------S------------------QQ-----------------T---TT-------------------------------QQ---Q-------------------SS--S---SSS-----SSSSSSSSSS
S-S------------SSSSSSSST------------TT-------#---------------t-------------------------------------T--TT----TT-----T---##---------#-------------------------#------------SS----TSSSSSSSSSSS
S--------------SSSSSSSST------------TT------##-----------------------------------------------------T---T----TT----TT---tt--------##--tt--------------------##--------SS--S-----T-SSSSSSSSSS
S--------------SSSSSSSST------------TT-------#---------------t------------------------------------TT--TT-----T----TT---tt--------##--t--------------------###------k-----------TSSSSSSSS-SS
XXXXXXXXXXXXXXXXXXXXXXXXXXXXXXXXXXXXXXXXXXXXXX--------------XXX-XXXXX------X-----X----------XXXXXXXXXXXXXXXXXXXXXXXX---XX-XX-XX--XXXXXXXXXXXXXX--XXXXXXXXXXX-----XXXXXXXXXXXXXXXXXXXXXX--X-
XXXXXXXXXXXXXXXXXXXXXXXXXXXXXXXXXXXXXXXXXXXXXX--------------XXX--XXX-------X-----X----------XXXXXXXXXXXXXXXXXXXXXXXX---XXXXXXXX--XXXXXXXXXXXXXX---XXXXXXXXXX-----XXXXXXXXXXXXXXXXXXXXXXX-X-