-------------------------------------------------------------------------------------------------------------------------------------------------------------------------------------------
S------------------------------------------------------------------------------------------------------------------------------------------------------------------------------------------
S------------------------------------------------------------------------------------------------------------------------------------------------------------------------------------------
S-------SSSSSSSSSSSSSSSSSSSSSSSSSSSSSSSSSSSSSSSSSSSSSSSSSSSSSSSSSSSSS---SSSSSSSSSSSSSSSSSSSSSSSSSSSSS------SSSSSSSSSSSSSSS---SSSSSSSSSSSSSSSSSSSSSSSSSSSSSSSSSSSSSSSSSSSSSSSSSSSSSSSSSSSSSS
S------------------------------------------------------SSSSSSSS-----------SS----------SSSSSSSSSSS----------------------------SSSSSSSSSSSSSSSSSSSSSSSSSS----------SSSSSSSSSSSSSS------------
S------------------------------------------------------SSSSSSSS-----------SSS---------SSSSSSSSSSS----------------------------SSSSSSSSSSSSSSSSSSSSSSSSSS----------SSSSSSSSSSSSSS------------
S------------------------------------------------------SS--SSSS-----------SSSS-----------SSSSSSSS-SSS------------------------SSSSSSSSSSSSSSSSSSSSSSSSSS-----------SSSSSSSSSSSSS------------
S------------------------------------------------------------------------------------------------------------TT----------------------------------------------------------------------------
S-----------------------------------------------------SS-------------SS------------------------SS------------T-----------------------------------------------------------------------------
S------------------------------------------------------S---------------------------------------S------------TT-----------------------------------------Sooooo-----------SoooS--------------
S---------------------------------------------------------------QQ--------------SSTT---S----------QQ---------TT------SSS-----SSSSSSSSSSSSSSSSSSSSSSSSS-SSSSSS--#---SSSSSSSS----------------
S----------------------#-------------------------------------#---------------t----TT---S--SSS----------------TT------SSSSSS--SSSSSSSSSSSSSSSSSSSSSSSS---------##----SSSSSS-----------------
S---------------------##-----------------t-------------------#--------------SSS----T------SSSSSS------t-------T------SSSSSS--SSSSSSSSSSSSSSSSSSSSSSST--------##S----SSSSSS--------#------S-
S---------------------##-----------------t----------------------------------------TT-----------------tt------------k-SS---S--SSSSSS---SSSSSSSSSSSSSTT---k----##S-----------------##------S-
XXXXXXXX--XXXXXXXXXXXXXXXXXXXX------XXXXXXXXXXXX-----XXX---XXXXXXX--------XXXXXXXXXXXXXXXXXXXXXXXXXXXXXXXXXXXXXXXXXXXXX-XXX--XX--XX--XXXXXXXXXXXXXXXX-XXXXXXXXXXXXXXXXXXXXXXXXXXXXX--------
XXXXXXXX--XXXXXXXXXXXXXXXXXXXX------XXXXXXXXXXXX-----XXX---XXXXXXX--------XXXXXXXXXXXXXXXXXXXXXXXXXXXXXXXXXXXXXXXXXXXXXXXXX--XX--XX--XXXXXXXXXXXXXXXX--XXXXXXXXXXXXXXXXXXXXXXXXXXXX--------