-------------------------------------------------------------------------------------------------------------------------------------------------------------------------------------------
-------------------------------------------------------------------------------------------------------------------------------------------------------------------------------------------
-------------------------------------------------------------------------------------------------------------------------------------------------------------------------------------------
S--SSSSSS--SSSSSSSSSSSSSSSS---------SSSSSSSSSSSSSSSSSSSSSSSSSS---------SSSSSSSSSSSSSSSSSSSSSSSSSSSSSSSSSSSSSS-SSSSSSSSSSSSSSSSSSSSSSSSSSSSSSSSSSSSSSSSSSSSSSSSSSSSSSSSSSSSSSSSSSSSSSSSSSSSS
S-----------SS----SS--------------------------SSSSSS-----------------------------------------------------------SSSSSS----------------------------------------------------------------------
S-----------------SS-----------------------------SSS----------------------------------------------------------SSSSSSS----------------------------------------------------------------------
S---------------S-----------------------------------Q--------------------------------------------------------S-----SSSSSSS-----------------------------------------------------------------
S-----------------------------------------------------------------------------------------TT---------------------------------------------------------------------T-------------------------
S---------------SS-----------------------------------------------SSS----------------------TT-----------------S---------------------------------------------------TT--------Q---------------
S-----------------------------------------------------------------------------------------TT-----------------S-S-------------------------------------------------TT------------------------
S---------------------QQ-----------------------S-------------------------------------S--SSTT--------SS------------SSSS---------T-----------------------S---------TT----------------------SS
S----------------------------------------------------------------------#--TT--------------TT-------------##--------------S----TT----TT---------------------TT----TT--TT---------#--------SS
S--------------------------------------------------#-------------------#--TT--------------TT----------S-###--------------t----TT----TT-------------tt------TT----TT--TT----t---##--------SS
S-------------------------------------------------##------------------##--TT--------kt---kTT---k--------###-------------------TT---tST---kS--------tt--k---TT--kTT---T-----t---##--------SS
S-XXXXXXXXXXXX-------XXX---XXXXXXXXXXXXXXXX-XXXXXXXXXXXX-------XX----XXXXXXXXXXXXXX-XXXXXXXXXXXXXXXXXXXXXXXXXXXXXXXXXXXXXXXXXXXXXXXXXXXXXXXXXXXXXXXXXXXXXXXXXXXXXXXXXXXXXXXXXXXXX----XXX-XX
-SXXXXXXXXXXXX-------XXX---XXXXXXXXXXXXXXXXXXXXXXXXXXXXXX------X-----XXXXXXXXXXXXXX-XXXXXXXXXXXXXXXXXXXXXXXXXXXXXXXXXXXXXXXXXXXXXXXXXXXXXXXXXXXXXXXXXXXXXXXXXXXXXXXXXXXXXXXXXXXXX----XXX-XX