----------------------------------------------------------------------------------------------------------------------------------------------------------------------------------------
----------------------------------------------------------------------------------------------------------------------------------------------------------------------------------------
----------------------------------------------------------------------------------------------------------------------------------------------------------------------------------------
----------------------------------------------------------------------------------------------------------------------------------------------------------------------------------------
----------------------------------------------------------------------------------------------------------------------------------------------------------------------------------------
----------------------------------------------------------------------------------------------------------------------------------------------------------------------------------------
------------------------------------------------oo-----------------y--------#S---------------------------------------------------------SSS------------S---------------------------------
-------------------------------------------------------------------#SSSS---##--------------------------------------y--------------------------------------------------------------#S----
-----------------------------oo-----------------------------------##-------##--y-------------------------------------------------------------------------------------------------###----
------------------------------------------------------------------##------####SS--oo-----------------------------------SS------------------y------------------------------------####----
---------------###---------##---SC---------###S------------------###------###----------------QQ--------------###---###---------------------SSC-----#----------------------------####----
--------------####-SSS----###------------###--------------------####---#--####--------------------------########--####----------------------------##----------------------------####----
-------------#-##--------####-----------##---------------------#####---#--####-------y-----------------#####------####-------------------#----SS-###--------------------------#-####----
X-----------#--##-------#-####--------------------------------#--###-------###----SSSS---y---y-------####----------###-----S---------------------###-----------y-------------##--###----
XXXXXXXXXXXXXXXXXXXXXXXXXXXXXXXX--XXXXXXXXXXXXXXXXXX--XXXX--XXXXXXXXXXX---XXX--------XXXXXXXXXXXX-XXXXXX----------XXXX--XX---XXXXXXXXXXXXXXXXX-XXX--XXXXX-XXXXXXXXXXXXXXXXXXXXXXXXXXXX--
XXXXXXXXXXXXXXXXXXXXXXXXXXXXXXXX--XXXXXXXXXXXXXXXXXX--XXXX--XXXXXXXXXXX---XXX--------XXXXXXXXXXX--XXXXXX----------XXXX--XX---XXXXXXXXXXXXXXXXX--XX--XXXXX-XXXXXXXXXXXXXXXXXXXXXXXXXXXX--