----------------------------------------------------------------------------------------------------------------------------------------------------------------------------------------
----------------------------------------------------------------------------------------------------------------------------------------------------------------------------------------
----------------------------------------------------------------------------------------------------------------------------------------------------------------------------------------
----------------------------------------------------------------------------------------------------------------------------------------------------------------------------------------
----------------------------------------------------------------------------------------------------------------------------------------------------------------------------------------
----------------------------------------------------------------------------------------------------------------------------------------------------------------------------------------
-------------------##----------------------------------------------------------------------------------------------------------y--------------------------------------------------------
----------------------------------------------------------------------------------------------------------------------------------------------------------------------------------------
------------------#-#-------------------------------------------------------------------------------------------------------------------------------------------------------------------
------------------###-------------------------------------------------------------------------------------------------------------------------------------------------------------------
------------------#--------Q----------QQ---------###---------------------------------------#--S-----------------------------#--#SC-------------------------------------o--------##------
----------------#-####-#------------------------####--------------------------------------##----------------------------######---------------------S---------------------------##-------
---------------#######-------------------------#####------------------------------------y--#---------------------------#######---SSS-------------------------------------------#--------
---------------#####---------------y-----------#####-----------------y-------y-------y-----#-------------------y------####---#-----------y---#-#-------------------------------##-------
XXXX---XXXXXXXXXXXXX-----XXXXX--XXXXXXXXXXXXXXXXXXXXXX----XX--XX--XXXXXXXXXXXXXXXXXXXXXXXXXXXXXX--XXXXXXXXXXXXXXXXXXXXXXXXXXXXX-----XXXXXXXXXXXXXXX---XX--XXXX--XXXXXXXXXXXXXXXXXXXXXXXX
XXXXX---XXXXXXXXXXXX----XXXXXX--XXXXXXXXXXXXXXXXXXXXXX----XX--XX--XXXXXXXXXXXXXXXXXXXXXXXXXXXXXX--XXXXXXXXXXXXXXXXXXXXXXXXXXXXXX----XXXXXXXXXXXXXXX---XX--XXXX--XXXXXXXXXXXXXXXXXXXXXXXX