----------------------------------------------------------------------------------------------------------------------------------------------------------------------------------------
----------------------------------------------------------------------------------------------------------------------------------------------------------------------------------------
----------------------------------------------------------------------------------------------------------------------------------------------------------------------------------------
----------------------------------------------------------------------------------------------------------------------------------------------------------------------------------------
-----------------------------------------#----------------------------------------------------------------------------------------------------------------------------------------------
----------------------------------------------------------------------------------------------------------------------------------------------------------------------------------------
----------------------------y---------##------------##------------------------------------------------------------SS--------------------------------------------------------------------
---------oo---------------#SSS-------#---------------------------------------------------------------------------#----------------------------------------------------------------------
--------------------------#---------S--------------###----------------------------------------------------------------------------------------------------------y-----------------------
-------------------------###-------#---------------###---------------------------------------------------------------------------------------------------------##S----------------------
-----#-----------------#------##------S------------###----oo------Q--------------oQQ---QQ--------------#-------#------####---------------------------------------#----------------------
----##----------------######-###-----------------####---------------------------------------------TT---#-----###--######----------------TT-----------------#---###----------------------
---###---------------######--#-#-------SSS-------###----------------------------------------------TT--------####--#---------------------TT---------------###---###----------------------
----##--------------####-----#-#------------------##---------------------y----------------------y--T--------##-#--------------SSSS---------------y------#------###----------------------
XXXXXXXXXXXXXXXXXXXXXXXXX----XXX--XX------XXXXXXXXXXX-XXXXXXXXXXXXXXX-XXXXXXXXXXXXXXXXXXXXX--XXXXXXXXXXXXXXXXXXX----------XX------XXXXXXXXXXXXXXXXXX--XXXXXX---XXXXXXXXXXXXXXXXXXXXXXXXX
XXXXXXXXXXXXXXXXXXXXXXXXX-X--XXX--XX------XXXXXXXXXXXXXXXXXXXXXXXXXXX-XXXXXXXXXXXXXXXXXXXXX--XXXXXXXXXXXXXXXXXXX----------XX------XXXXXXXXXXXXXXXXXX--XXXXXX--XXXXXXXXXXXXXXXXXXXXXXXXXX