----------------------------------------------------------------------------------------------------------------------------------------------------------------------------------------
----------------------------------------------------------------------------------------------------------------------------------------------------------------------------------------
----------------------------------------------------------------------------------------------------------------------------------------------------------------------------------------
----------------------------------------------------------------------------------------------------------------------------------------------------------------------------------------
----------------------------------------------------------------------------------------------------------------------------------------------------------------------------------------
----------------------------------------------------------------------------------------------------------------------------------------------------------------------------------------
-----------------------------------------------------------------------------#---------------------------------------------------------####--------------------o------------y-----------
--------------------------------------------------------------------------##-#-------------------------SSSS---------------------------####--------------------------------#SS-----------
-----------------------o-----------------------------------------------y--##--------------------------------------------Q--------------###------------------SS-----------##-------------
-----------------------------------------------------------------------#--##--------------------------------------------------------#--###-----------------#------------###-------------
----SC------------SC--------------------------------------------------##--##------------------------##--SC-------------------------#---###----------------##-------------##-----o-------
----------------------------------------TT----------------------------######--------------####-----###------SS-------------------y-###-#-#---------------###---------y##-##-------------
----------------------------------------TT-------------------------y#-####-#-------------#--##-----###---------------T-----------#####---#--------------####---------###-###------------
-----------------------------y---y---y--TT-------y-------------y--###--#-#-#----------------#------###---------------TT--------#######--------TT-------#####-------#####-##-------------
XXX----XXXXXXXXXXXXX--XXXXXXXXXXXXXXXXXXXXXXXXXXXXXXXXXXXXXXXXXXXXXXXXXXXXXX--X---XXXXXXXXXXXX--XX-XXX--XX--XX--XXXXXXXX--XXXXXXXXXXXX--XXXXXXXXXXXXXXXXXXXXXXXX-XXXXXXXXXXX--XXXXXXXXXX
XXX----XXXXXXXXXXXXX--XXXXXXXXXXXXXXXXXXXXXXXXXXXXXXXXXXXXXXXXXXXXXXXXXXXXXX--X---XXXXXXXXXXXX--XX-XXX--X---XX--XXXXXXXX--XXXXXXXXXXXX--XXXXXXXXXXXXXXXXXXXXXXXX-XXXXXXXXXXX--XXXXXXXXXX