----------------------------------------------------------------------------------------------------------------------------------------------------------------------------------------
----------------------------------------------------------------------------------------------------------------------------------------------------------------------------------------
----------------------------------------------------------------------------------------------------------------------------------------------------------------------------------------
----------------------------------------------------------------------------------------------------------------------------------------------------------------------------------------
----------------------------------------------------------------------------------------------------------------------------------------------------------------------------------------
----------------------------------------------------------------------------------------------------------------------------------------------------------------------------------------
----------------------------------------------------------------------##S---------------------------------------------------------------------------------------------------------------
---------------------------------------------------------------------###----------------------##-------#--------------------------------------------------------------------------------
---------------------------------------------------------------------###----------------------##------###---oo-------------------------------oo-----------------------------------------
-------------------------------------------------------------------#####---------------------###-------##-------------------------------------------------------------------------------
----------o-------------------------------------oo----------------##-###---------------------###-------###----------------------------------------QQ------------------------------------
------------------------------------------------------------------##-###---------------------###--SS##-###------------------------------------------------------------------------------
-----------------------------------------------------------------#---###-------------------#####-------###-----------------------------###----------------------------------------------
-------------------y-------------------------------------y----------####----------y--y----######--------#-----------------------------####----------------------------------------------
XXXXXXXXXXXXXXXXXXXXXXXXXXXXXXXXXXXX----XXXXXX--XX--XXXXXXXXXXXXXXXXXXXXXX--XXXXXXXXXXXXXXXXXXXX----XX-XXX--XXXXXXXXXXXXXXXXXXXXXXXXXXXXXXXX--XXXXXXXXXXXXXXXXXXXXXXXXXXXXXXXXXXXXXXXXXX
XXXXXXXXXXXXXXXXXXXXXXXXXXXXXXXXXXXX----XXXXXX--XX--XXXXXXXXXXXXXXXXXXXXXX--XXXXXXXXXXXXXXXXXXXX----XX-XXX--XXXXXXXXXXXXXXXXXXXXXXXXXXXXXXXX--XXXXXXXXXXXXXXXXXXXXXXXXXXXXXXXXXXXXXXXXXX