----------------------------------------------------------------------------------------------------------------------------------------------------------------------------------------
----------------------------------------------------------------------------------------------------------------------------------------------------------------------------------------
----------------------------------------------------------------------------------------------------------------------------------------------------------------------------------------
----------------------------------------------------------------------------------------------------------------------------------------------------------------------------------------
----------------------------------------------------------------------------------------------------------------------------------------------------------------------------------------
----------------------------------------------------------------------------------------------------------------------------------------------------------------------------------------
------------------------------------------------------------SS----------------------------------------------------------------------------------------------------##---------------y-y--
-----------------------------------------------------------#-------------------------------------------------------##S-----------------y--------------------------##---------------#SS--
---------------------------------###----------------------##-------------------------------------------------------#--------o---------##-------------------------###--------------##----
----------------------------------##---------------------###---------------------------------------------------------#----------------##-------------------------###--------------##----
------------QQQ---------##--SC---###---SC-----------------##---------#SSSC---------------#####---###SS---------------#---SS----------###-------------------------###------------y-##----
-----------------------#-#-------###-------------------#-###-----S----------------------####-----###----------------##--------------####----------------------######------------#-##----
-----------------------###-------###------------------######----------------------------##-------##-----------------##-----S-------#-###---------------------#######-----------##-##----
------y--y------------####--------##-----------------#######----------------------TT-------------##-----------------##---------SSS##-###--------------------########----------######----
XXXXXXXXXXXXXXXXX--XXXXXXXXX--XXXXXXXXXXXXXXXXXXXXXXXXXXXXXX------XXXXXXXXXXXXXXXXXXXXXXXXXXXX--XXXXXXXXXXXXXXXXXXXXXXXX-------------XXX--XXXXXXXXX-XX--XXXX--XXXXX---XX--XXXXXXXXXXXX--
XXXXXXXXXXXXXXXXX--XXXXXXXXX--XXXXXXXXXXXXXXXXXXXXXXXXXXXXXX------XXXXXXXXXXXXXXXXXXXXXXXXXXXX--XXXXXXXXXXXXXXXXXXXXXXXX------------XXXX--XXXXXXXXXXXX--XXXX--XXXXX---XX--XXXXXXXXXXXX--