----------------------------------------------------------------------------------------------------------------------------------------------------------------------------------------
----------------------------------------------------------------------------------------------------------------------------------------------------------------------------------------
----------------------------------------------------------------------------------------------------------------------------------------------------------------------------------------
----------------------------------------------------------------------------------------------------------------------------------------------------------------------------------------
----------------------------------------------------------------------------------------------------------------------------------------------------------------------------------------
----------------------------------------------------------------------------------------------------------------------------------------------------------------------------------------
-----------------------------------------------------------------------------------ooo----------------------------------###-----------------------------------------oo------------------
-------------------------------#-----------------------S-------------------------------------------------y--------------###-------------------------------------------------------------
-----------------------------###---------#S-------------------ooo----------------------------------------#--------------###---------------------------------------#---------------------
-----------------------------###----oo--##--------#S--------#-------------------------------------------##--------------###---------------------------------------#---------------------
-----------------------------###-------###-------##---SC---#------------------------2-----S------------###--------------###--------------------------------------##---------------------
-----------------------------###-------###------###-------###-----------------------------------------####------------#####--------------------------------------#----------------------
-----------------------------###-------###-----####----SS##------------------------------------------#####-----------#####------------y-------------------------#-#---------------------
----------------------------####--SSS--###----##----------------SS---y---SSS---------------------y-----###----------#####------------------------------y--------###---------------------
XXXXXXXXXXXXXXXXXXXXXXXXXXXXXXXX------XXXXXX----XX--------XXX-XX--XXXXXXXXXXXXXXXXXXXXXXXX--XXXXXXXXXXXXXXXXXXXXXXXXXXXXXXXXXXXXXXXXXXXXXX--XXXXXXXXXXXXXX--XXXXXXXXXXXXXXXXXXXXXXXXXXXX
XXXXXXXXXXXXXXXXXXXXXXXXXXXXXXXX------XXXXXX----XX--------XX--XX--XXXXXXXXXXXXXXXXXXXXXXXX--XXXXXXXXXXXXXXXXXXXXXXXXXXXXXXXXXXXXXXXXXXXXXX--XXXXXXXXXXXXXX--XXXXXXXXXXXXXXXXXXXXXXXXXXXX