----------------------------------------------------------------------------------------------------------------------------------------------------------------------------------------
----------------------------------------------------------------------------------------------------------------------------------------------------------------------------------------
----------------------------------------------------------------------------------------------------------------------------------------------------------------------------------------
----------------------------------------------------------------------------------------------------------------------------------------------------------------------------------------
----------------------------------------------------------------------------------------------------------------------------------------------------------------------------------------
----------------------------------------------------------------------------------------------------------------------------------------------------------------------------------------
--------------------------------oo----------oo------------------------------------------oo----------------------------------------------------------------oo----------------------------
------------------------------------------------------------------------------------------------------SS--------------------------------------#S----------------------------------------
----------------------------------------So-----------------------------y--y------------------------------------------------------#Sy-------------------------------#--------------------
------------------#S-----------#---------------------------------------###SS-----------------------------------------------------#-------------#------------------##--------------------
---------------y-##-S----------#-----##--------------------------------##-----------SS--------------##---SS--------------------###------------##S--------#-------###--2------------##---
--------------####------------##-------#-----------------------------#####--------TT------------------------------------------####-----------###--------##-------###--------------##----
-----------y-#####----------####-----------------------------y------######--------TT--------------##-------------------------#####-----------###--------##------####-------------#-#----
-------y---####------------#####-----------------y-----y----##-------#####--SSSS--TT------------#####----------------------#######----SS----####---------#------####---------y--#-------
--XXXXXXXXXXXXXX---XXXXXXXXXXXXX----XXXXXXXXXXXXXXXXXXXXXXXXXXXX------XXXX-----XXXXXXXXXXXXXXXXXXXXXXXXXXXXXXXXXXXXXXXXXXXXXXXXXXX------XXXXXXXXXXXXXXXXXXXXXXXXXXXXXXXXXXXXXXXXXXXXXXX-
--XXXXXXXXXXXXXX---XXXXXXXXXXXXX----XXXXXXXXXXXXXXXXXXXXXXXXXXXX------XXXX-----XXXXXXXXXXXXXXXXXXXXXXXXXXXXXXXXXXXXXXXXXXXXXXXXXXX------XXXXXXXXXXXXXXXXXXXXXXXXXXXXXXXXX-XXXXXXXXXXXXX-