----------------------------------------------------------------------------------------------------------------------------------------------------------------------------------------
----------------------------------------------------------------------------------------------------------------------------------------------------------------------------------------
----------------------------------------------------------------------------------------------------------------------------------------------------------------------------------------
----------------------------------------------------------------------------------------------------------------------------------------------------------------------------------------
----------------------------------------------------------------------------------------------------------------------------------------------------------------------------------------
----------------------------------------------------------------------------------------------------------------------------------------------------------------------------------------
----------------------------------------------------------------------------------------------------------------2-----------------------------------------------------------------------
---------y-----------------------------------------------------------------------------------------------------------------------------------------------y------------------------------
---------#----------oo-------y--oS---------------------------------------SS---------------------------------------------------------o--------------------##-----------------------------
--------##-------------------y-------------------------------------------------------------------------------------------------y------------------------###-----------------------------
-------###-------------------#-------------------------------------------------------------------------------y##-SSC--S--------#--SC-------###----------####------------SQ--------------
-----#####------------------##-------------------------------------------------------------------------------###--------------##----------####----------####----------------------------
-----####-----------SS-----###---------------------------------------###------------------------------------####----SS--------##---SSS--######----------####----------------------------
------###-----------------####-------------------------------###---#####---------y--------------------------####--------------##-------#######----------####--------------------y-------
XXXXXXXXXXXX-----XX---XXXXXXXXXX--XXXXXXXXXXXXXXXXXXXXXXXXXXXXXX-XXXXXXXXX----XXXXXXXXXXXXXXXXXXXXXXXXXXXXXXXXXX------XXXXXXXXXXXX----XXXXXXXXXXXXXXXXXXXXXXXXXX--XXXXXXXXXX-XXXXXXXXX--
XXXXXXXXXXXX----XXX---XXXXXXXXXX--XXXXXXXXXXXXXXXXXXXXXXXXXXXXXX-XXXXXXXXX----XXXXXXXXXXXXXXXXXXXXXXXXXXXXXXXXXX------XXXXXXXXXXXX----XXXXXXXXXXXXXXXXXXXXXXXXXX--XXXXXXXXXX-XXXXXXXXXX-