----------------------------------------------------------------------------------------------------------------------------------------------------------------------------------------
----------------------------------------------------------------------------------------------------------------------------------------------------------------------------------------
----------------------------------------------------------------------------------------------------------------------------------------------------------------------------------------
----------------------------------------------------------------------------------------------------------------------------------------------------------------------------------------
----------------------------------------------------------------------------------------------------------------------------------------------------------------------------------------
----------------------------------------------------------------------------------------------------------------------------------------------------------------------------------------
----------------------------------------------------------------------------------------------------------y-----------------------------------------------------------------------------
----------------------------------------------------------------------------------------------------------------------------------------------------------------------------------------
----------------------------------------------------------2---------y----------y-y---------------------#----------o--------------###----------------------------------------------------
---------------------------------------------------------------------#---------#SS-#o-----------------##------------------------####----------------------------------------------------
-------SSC------ooQ---------------------#y--------------------------##--------##--------####---------##------------------------#####--------##--S----------------o---------###----------
-----------------------------------------#------------------------##-#-------###-------y###---------###-----------------------#--##---------------------------------------###-----------
-----------------------------------y#---##----------------------####---------###-------###---------####----------------------##--##---------------------------------------###-----------
-----------------------------------#######----------------y----###----------####---SS----#---------##-------------------------#-##-----------------------y---------------####-----------
XXXXXX--------XX--XXX-XXXXXXXXXXXXXXXXXXXXXXX----XXXXXXXXXXXXXXXXX---X---XXXXXXX------XXXXXXXX--XXXXXX------XX-----XXXXXXX--XXXXXX--XXX-XXXXXXXXXXXXXXXXXXXXXXXXXXXXXXXXXXXXXXXXXXXX----
XXXXXX--------XX--XXXXXXXXXXXXXXXXXXXXXXXXXXX----XXXXXXXXXXXXXXXXX-------XXXXXXX------XXXXXXXX--XXXXXX------XX-----XXXXXXX--XXXXXX--XX-XXXXXXXXXXXXXXXXXXXXXXXXXXXXXXXXXXXXXXXXXXXXX----