-------------------------------------------------------------------------------------------------------------------------------------------------------------------------------------------------------------------------------------------------------------------------------------------------------------------------------------------------------------------------------------
-------------------------------------------------------------------------------------------------------------------------------------------------------------------------------------------------------------------------------------------------------------------------------------------------------------------------------------------------------------------------------------
-------------------------------------------------------------------------------------------------------------------------------------------------------------------------------------------------------------------------------------------------------------------------------------------------------------------------------------------------------------------------------------
-------------------------------------------------------------------------------------------------------------------------------------------------------------------------------------------------------------------------------------------------------------------------------------------------------------------------------------------------------------------------------------
-------------------------------------------------------------------------------------------------------------------------------------------------------------------------------------------------------------------------------------------------------------------------------------------------------------------------------------------------------------------------------------
-------------------------------------------------------------------------------------------------------------------------------------------------------------------------------------------------------------------------------------------------------------------------------------------------------------------------------------------------------------------------------------
----------------------------------------------------------------------------------------------------------------------------------------------------------------------------------------------------------------------------------SS---------------------------------------------------------------------------------------------------------SS--------------------------------------
-------------------------------------------------------------------------------------------------------------------------------------------------------------------------------------------------------o---------------------------------------------------o-------------------------------------------------------------------------------------------------------------------------
-------------------------------------------------------------------------------------------------------------------------###-CSSS-St-------------------------------------------------------------------------------------------------------------------------------------------------------------------------------------------------------------------------------------------------
-----------------------------------------------------------------------------------o------------------------------------#----------t-----------------------------------------o-------------------#-----------------------------------------------------------------------------------------------------------------------------------------------------------------------------------
----------oo-----------TT------TT---------------------------------------------------------------TT---------------------##----------t---TT----------------T---------------------------------------#-------------------------------------------------------------------------------------------------------T---------------------------------------------------------------------------
-----------------------TT-----TT---------------------------t------------------------------------TT---------o--TT------####---------t---TT----------------T-----------------------------------T---#---------------------------------o-----------------------------------------------------TT--------------TT--------------------------------------oo----------------------------------
-----------------------TT-----T-----------------------#--------------#---------------------#----TT------------TT-----#-###--------tt---TT--------------------------------------------------------t---------------------------------#-------------------T---------------------------------TT--------------------------------------------------#---------------------------------------
-----------------------TT-----TT-----------------------------------kk#---------------------#--ggTT----ggg-----TT----k#-#-#--------tt---TT-----ggg---------------------kk-------------------------t-k------------------------k------#----------k-------k-------------k-------k------------TT-----------------------g-k--------ggg-------ggg---#------------------------ggg----k-gg----
XXXXXXXXXXXX----XXXXXXXXXXXXXXXXXXXXXX----XX--X-XXXX-XX-X-XXXXXXXXXXXXXXXXXXXXXX----XXXXXXXXXXXXXXXXXXXXXXXXXXXXXXXXXXXX-XXXXXXX--XXXXXXXXXXXXXXXXXXXXXXXXXXXXXXXXXXXXXXXX----XXXXXXXXX-XX-XXXXXXXXXXXXXXXXXXXXXXXXXXXXXXXXXXXXXXXXXXXXXXXX-XXXXXXXXXXXXXXXXXXXXXXXXXXXXXXXXXXXXXXXXXXXXXXXXXXXXXXXXX--XXXXXX-XXXXXXXXXXXXXXXXXXXXXXXXXXXXXXXX-X-XX-XX-X-XXXXXXXXXXXXXXXXXXXXXXXXXXXX
XXXXXXXXXXXX----XXXXXXXXXXXXXXXXXXXXXX----XX--XXXXXX-XX-X-XXXXXXXXXXXXXXXXXXXXXX----XXXXXXXXXXXXXXXXXXXXXXXXXXXXXXXXXXXXXXXXXXXX--XXXXXXXXXXXXXXXXXXXXXXXXXXXXXXXXXXXXXXXXX----XXXXXXXX--X-XXXXXXXXXXXXXXXXXXXXXXXXXXXXXXXXXXXXXXXXXXXXXXXX-XXXXXXXXXXXXXXXXXXXXXXXXXXXXXXXXXXXXXXXXXXXXXXXXXXXXXXXXX--XXXXXXXXXXXXXXXXXXXXXXXXXXXXXXXXXXXXXXXXXXXXXXXXXXXXXXXXXXXXXXXXXXXXXXXXXXXXXX