-------------------------------------------------------------------------------------------------------------------------------------------------------------------------------------------------------------------------------------------------------------------------------------------------------------------------------------------------------------------------------------
-------------------------------------------------------------------------------------------------------------------------------------------------------------------------------------------------------------------------------------------------------------------------------------------------------------------------------------------------------------------------------------
-------------------------------------------------------------------------------------------------------------------------------------------------------------------------------------------------------------------------------------------------------------------------------------------------------------------------------------------------------------------------------------
-------------------------------------------------------------------------------------------------------------------------------------------------------------------------------------------------------------------------------------------------------------------------------------------------------------------------------------------------------------------------------------
-------------------------------------------------------------------------------------------------------------------------------------------------------------------------------------------------------------------------------------------------------------------------------------------------------------------------------------------------------------------------------------
-------------------------------------------------------------------------------------------------------------------------------------------------------------------------------------------------------------------------------------------------------------------------------------------------------------------------------------------------------------------------------------
--------------------o--------------------------------------------------------------------------------------------------------------------------------------------------------------------------------------------------------------------o-------------------------------------------------------------------------------------------------------------------------------------------
------------------##------------------------o----------------------------------------------------------------------------------------------------------------------------------------------------------------------------------------------------------------------------------------------------------------------------------------------------------------------------------------
-----------------##------------------------------------------------------------------------SSSS--------S-#SSSCSSS-------------------------------------------------------------------------------------------------------------------------------------------------------------------------------S----------------------------------SSSS----------##----------------------------------
----------------###-------------------------------------------o----------------------------------------------------------------------------------------------------------------------------------------------------------------------------------------------------------------------------------------------------------------------------------##----------------------------------
--------------#-##-----------------------------------------T------------------------------------------------------------------------------------------------------------------------------TT---------------o--------------------------------------------------TT---------------------##--------------------------------------------------------#-##----------------------------------
--------------#-#-----------------------------------------TT-----------------#-------------------------------------------------------------------------------------------------------------T-----T-----------------------------------------------------------TTT-------------------------------------------------------------------------------#-##-------------------------o--------
-----#--------#-#-----------------------------------------TT----------------t#----------------------tt-------------------------------------------------------------------------------------T-----T---t-----------------------------------#-------------------TTT-------------TT------##--#---#-----------------------------------------------#-#-##---------------------T------------
ggg-#---------#-#-----------------g--g-------gg-------gg--TT--------ggg-#---tt---t----ggg-----------tt----------------------k-k-k-k----g------k--k------------ggg----gg--------------kk---TT-----T---t------------kkk--------------kkkkk-#-------------------TTT-----TT------TT----gg##----------------------ggg-----XX----------------------#-#-##--------------------TT------------
XXXXXXXXXXXXXXXXXXXXXXXXXXXXXXXXXXXXXXXXXXXXXXXXXXXXXXXXX-XX--X-XXXXXXXXXXXXXXXXXXXXXXXXXXXXXXXXXXX-XXX-XXXXXXXXXXX-XXXXXXXXXXXXXXXXXXXXXXXXXXXXXXXX-X--X-XXXXXXXXXXXXXXXXXXXXXXXXXXXXXXXXXXXXXXXXXXXXXXXXXXXXXXXXXXXXXXXXXXX-XXXXXXXXXXXXXXX-X-X-------XXX--XX-XXXXXXXXXXXXXXXXXXXXXXXXXXXX-XX----XX-XXXXXXXXXXX-XXXXXXXXX---XXXXX-XXXXXXXXXXXXXXXXXXXXX-XXX--XXXXXXXXXXXXXXXXXXXXXX
XXXXXXXXXXXXXXXXXXXXXXXXXXXXXXXXXXXXXXXXXXXXXXXXXXXXXXXXXXXX--X-XXXXXXXXXXXXXXXXXXXXXXXXXXXXXXXXXXX-XXXXXXXXXXXXXXX-XXXXXXXXXXXXXXXXXXXXXXXXXXXXXXXXXX--X-XXXXXXXXXXXXXXXXXXXXXXXXXXXXXXXXXXXXXXXXXXXXXXXXXXXXXXXXXXXXXXXXXXX-XXXXXXXXXXXXXXX-XXX---X---XXX--XX--XXXXXXXXXXXXXXXXXXXXXXXXXXX-XX----XX-XXXXXXXXXXXXXXXXXXXXX--XXXXXX-XXXXXXXXXXXXXXXXXXXXXXXXX--XXXXXXXXXXXXXXXXXXXXXX