-------------------------------------------------------------------------------------------------------------------------------------------------------------------------------------------------------------------------------------------------------------------------------------------------------------------------------------------------------------------------------------
-------------------------------------------------------------------------------------------------------------------------------------------------------------------------------------------------------------------------------------------------------------------------------------------------------------------------------------------------------------------------------------
-------------------------------------------------------------------------------------------------------------------------------------------------------------------------------------------------------------------------------------------------------------------------------------------------------------------------------------------------------------------------------------
-------------------------------------------------------------------------------------------------------------------------------------------------------------------------------------------------------------------------------------------------------------------------------------------------------------------------------------------------------------------------------------
-------------------------------------------------------------------------------------------------------------------------------------------------------------------------------------------------------------------------------------------------------------------------------------------------------------------------------------------------------------------------------------
-------------------------------------------------------------------------------------------------------------------------------------------------------------------------------------------------------------------------------------------------------------------------------------------------------------------------------------------------------------------------------------
-----------------------------------------------------------------------------------------------------------------------------------------------------------------------------------o-------------------------------------------------------------------------------------------------------------------------------------------------------------------------------------------------
-------------------------------------------------------------------------------------------------------------------------------------------------------------------------------------------------------------------------------------------------------------------------------------------------------------------------------------------------------------------------------------
--------------------------------------------------------------------------------------SSSCSSSS------------##--------------------------------------------------------------------------------------------------------------------------------------------------------------------------------------------------------------SSSUSSS-------------------------SSSCSS-oo------------------
--------------------------------------------------------------tt------------------------------------------##---------------------------------------------------------------------------------------------------------------------------------------------------------------------------------------------------------------------------------o-------------------#-------------------
------------TT--------------------------------------------TT--tt-------------------------------------#--#-##-----------T----------------------##---------------------o-----------------------TT--t---------------------------TT----------------------------------T-------------------------------------------------oo----------------------------------------------------------------
------------TT------------T--------------------------------T--tt----TT------------------------------##--####------TT--TT----------------------#----------------------------------------------TT--tt--------------------------TT----------------------------------TT----------------------------------------------------------------TT----TT-----------------------#------------------
----#-------TT-----------TTT-----------#-------------------T--tt----TT----------------------------#-###-#-##------TT--TT----------------TT--####-------------------------------#-------------TT--t---------------------------TT----------------------------------TT-------------------------------------T----#---------------------#T----TT----------------------#-------------------
-K--#---gg--TT-----------TT-----kk--kk-#--------------TT--TT--tt-k--TT------------k-k------------g###-#-#-##------TT--TT----------k-----TT--####--------k-k------gg-k------------------------TT--t--------------------k--ggk-TT-----k----ggg----k----------ggg---TT----X--------------gg---------------------#---------------------#T----TT----------#------------------------gg-T---
-XX-X-XXXXX-XX--XX--X-XXXXXXXXXXXXXXXXXXXXX---XXXXXXXXXXX-XX--XXXXXXXXXXXXXXXXXXXXXXXXX-------XXXXXXXXX-XXXXXXXXXXXXXX-X--XXXXXXXXXXXXXXXXX-XXXXXXXXX-XXXXXXXXXXXXXXXXXXXXXXXXXXXXXXXXXXXXX--XX-XXXXXXXXXXXXXXXXX-XXXXXXXXXXXXXXXXXXXXXXXXXXXXXXXXXXX-XXXXXXXXXXXXXXXXXXX-XXXXXXXXXXXXXXXXXXXXXXXXXXXXX-XXXXXXXXXXXXXXXXXXX--XXXXXXXXXXXXXXX-----XXXXXXXXXX--X-XX---X--X-XXXXXXXXXX--
XXXXXXXXXXXXXX--XX--X-XXXXXXXXXXXXXXXXXXXXX---XXXXXXXXXXX-XX--XXXXXXXXXXXXXXXXXXXXXXXXX-X-----XXXXXXXXXXXXXXXXXXXXXXXXXX--XXXXXXXXXXXXXXXXXXXXXXXXXXX-XXXXXXXXXXXXXXXXXXXXXXXXXXXXXXXXXXXXX--XX-XXXXXXXXXXXXXXXXX-XXXXXXXXXXXXXXXXXXXXXXXXXXXXXXXXXXXXXXXXXXXXXXXXXXXXXXX-XXXXXXXXXXXXXXXXXXXXXXXXXXXXX--XXXXXXXXXXXXXXXXXX--XXXXXXXXXXXXXXXX----XXXXXXXXXX--X-XX--XX--X-XXXXXXXXXX--