-------------------------------------------------------------------------------------------------------------------------------------------------------------------------------------------------------------------------------------------------------------------------------------------------------------------------------------------------------------------------------------
-------------------------------------------------------------------------------------------------------------------------------------------------------------------------------------------------------------------------------------------------------------------------------------------------------------------------------------------------------------------------------------
-------------------------------------------------------------------------------------------------------------------------------------------------------------------------------------------------------------------------------------------------------------------------------------------------------------------------------------------------------------------------------------
-------------------------------------------------------------------------------------------------------------------------------------------------------------------------------------------------------------------------------------------------------------------------------------------------------------------------------------------------------------------------------------
-------------------------------------------------------------------------------------------------------------------------------------------------------------------------------------------------------------------------------------------------------------------------------------------------------------------------------------------------------------------------------------
-------------------------------------------------------------------------------------------------------------------------------------------------------------------------------------------------------------------------------------------------------------------------------------------------------------------------------------------------------------------------------------
--------------SS-------------------------------------------------t-----------------------------------------------------------------------------------------------------------------------SSS-----------------------------------------------------------------------------------------------------------------------------------------------------------------------------------------
----------------------------------------------------------------tt-------------------------------------------------------------------------------------------------------------------------------------------------------------------------------------------------------------------------------------------------------------------------------------------------------tt----------
---------------------SS-----------------------------------------tt-------------------------------------------------------S---------------------------------------------------o-----------------------------------------------------------------------------------------------------------------------------------SSSSS---------------------------------------------------tt----------
----------------------------------------------------------------tt----------------------------------------------------------------------------------------------o------------o-------------------------------------------------------------------------------------------------------------------------------------------------------------------------------------------tt----------
----------------oo-------------------------#--oo-----------------o---------------------o---------------------------------------------------------------------------------------------------oo-------------------------------------------------------------------------------------------------------T--------#-#-----------------------------------------TT--------------------------
------------------------------------------##-------o-----------------------------o-----------------------------T---------------------------------TT------------------------------------o---------------------------------------#-------------------------#-----------------------TT----------------------------------------tt----------------------------TT-----------TT-------------
------------------------------------------#------------------#---#---------------------------------------------T-----------------------------------------------------------------------------------#-------------------------#-#---------#---------------#-----------------------TT--------------------------#-------------tt------------------------#---TT-----------TT-------------
----------ggg-----------------------------#----------g-------#--#-------------kk----------gg----k-----k-k------T-------------------------------kg--------g---------------------------------------k-#------ggg--------kk------#-#-------kk#----ggg---------------------k-X--------TT----------------gT--------#-#-----------tt--------------k-gg----kk#-kkTT-------gg--T----#-----ggg-
--XXXXXXXXXXXXXXXXXXXXXXXXXXXXXXXXXXXXXX--XX--XXXXXXXXX-X-XXXXXXXXXXXX--X-XXXXXXXXXXXXXXXXXXXXXXXXX---XXXXXXXXXXXXXXXXXX--X-XXXXXXXX-X------XXXXXXXXXXXXXXXXXX--------XXXXXXX-XXXXXXXXXXXXXXXXXXXXXXXXXXXXXXXXXXXXXXXXXXXXXXXXXXXXXXXXXXXXXXXXXXXXXXXXXX-XX----XXXXXXXXXXXXXXXXXXXXXX----XX-XXXXXXXXXXXXXXXXXXXXXXX-----X--XXXX---X----XXXXXXXXXXXXXXXXXXXXXXXXXXXXXXXXXXXXXXXXXXXXXX
--XXXXXXXXXXXXXXXXXXXXXXXXXXXXXXXXXXXXXX--XX--XXXXXXXXXXXXXXXXXXXXXXXX--X-XXXXXXXXXXXXXXXXXXXXXXXXX---XXXXXXXXXXXXXXXXXX--XXXXXXXXXX-X------XXXXXXXXXXXXXXXXXX--------XXXXXXX-XXXXXXXXXXXXXXXXXXXXXXXXXXXXXXXXXXXXXXXXXXXXXXXXXXXXXXXXXXXXXXXXXXXXXXXXXX-XX----XXXXXXXXXXXXXXXXXXXXXX----XX-XXXXXXXXXXXXXXXXXXXXXXX----XX--XXXX---X----XXXXXXXXXXXXXXXXXXXXXXXXXXXXXXXXXXXXXXXXXXXXXX