-------------------------------------------------------------------------------------------------------------------------------------------------------------------------------------------------------------------------------------------------------------------------------------------------------------------------------------------------------------------------------------
-------------------------------------------------------------------------------------------------------------------------------------------------------------------------------------------------------------------------------------------------------------------------------------------------------------------------------------------------------------------------------------
-------------------------------------------------------------------------------------------------------------------------------------------------------------------------------------------------------------------------------------------------------------------------------------------------------------------------------------------------------------------------------------
-------------------------------------------------------------------------------------------------------------------------------------------------------------------------------------------------------------------------------------------------------------------------------------------------------------------------------------------------------------------------------------
-------------------------------------------------------------------------------------------------------------------------------------------------------------------------------------------------------------------------------------------------------------------------------------------------------------------------------------------------------------------------------------
-------------------------------------------------------------------------------------------------------------------------------------------------------------------------------------------------------------------------------------------------------------------------------------------------------------------------------------------------------------------------------------
-----------------------------------------------------------------------------------------------------------------------------------#oo-----------------------------------------------------------------------------------------------------------------------------------------------------------------------------------------------------------------------------------------------
----------------------------------------------------------------------------------------------------------------oo----------------##-------------------------------------------------------------------------------------------------------------------------------------------------------------------------------------------------------------------------------------------------
-------SSS----------------------------------##---------------------------------------------oSSSSSSS------------------------------###--------------------------------------##---------------oo--------------------------------------#--S-S----------------------------------------------------------------##--------------------------------------------------------------------------
--------------------------------------------##----------------------------------------------------------------------------------####------------------------------------#--#-------------------------------------------------------#-----------------------------------------o---------------------------##------o--------------------------------o----------------------------------
-------------------------------#----------#-##---------------------TT----------------------------------------------------------#-###----------TT-----------------------#####-------------------------------------------------------#-------------------------------------------------------------------#-##----------------------------TT---------------------TT---------------------
------------------------------##----------#-##---------------------T-----------------------------------------------------------#-#-#----------TT---------------------#-#####---K-------------------------------------------------#-##---------------T----------#-----------------------------------#---#-##------------------------TT--T---------------------------t---TT------------
---------o------------------#--#-----#--#-#-##---------------------------------------------#--------------------------------#--#-#------------TT---------------------#-#-#-------------------------------------------------------#-##--------------TT----------#-----------------------------------#---#-##-------------------------T--tt------------------------------TT------------
----------------------------#k##--kkk---#-#-##--------k------------t------k-k--------------------------------------------------#-#-------gg---T#----kk----k-k-----g-##-#-#-----------k--------kkkk------------------k------ggg---#-##-----------k--TT------ggg-#----------------------ggg----kggg#-#-#-#-##----------------ggg----kT---tt------------------------------TT------------
---X-X--X-X---XXXXXXXXXXXXXXXXXXXXXXXXXXX-X-XXXXXXXXXXXXX-XXXXXX--XXX-XXXXXXXXXXXXXXXXXXXXXXXXXXXXXXX-XXXXXXXXXXXXXXXXXXXXXXXXXX-XXXXXXXXXXXXXXXXXXXXXXXXXXXXXXXXXXXXX-#-XXXXXXXXXXXXXX-XXXXXXXXXXXXXXXXXXXXXXXXXXXXXXXXXXXXXXXXXX-XXXXXXXXXXXXXXXXXXXXXXXXXXXXXXXXXXXXXX-X-X----XX--XXXXXXXXXXXXXXXXXXX-XXXX------XX--XXXXXXXXXXXXXXXXXXXXXXXX---X--XXXXXX--XXXXX-XXXXXXXXXXXXXXXXXX
X--X-X--X-X---XXXXXXXXXXXXXXXXXXXXXXXXXXXX#-XXXXXXXXXXXXXXXXXXXX--XX--XXXXXXXXXXXXXXXXXXXXXXXXXXXXXXX-XXXXXXXXXXXXXXXXXXXXXXXXXXXXXXXXXXXXXXXXXXXXXXXXXXXXXXXXXXXXXXXX-#-XXXXXXXXXXXXXXXXXXXXXXXXXXXXXXXXXXXXXXXXXXXXXXXXXXXXXXXXXXXXXXXXXXXXXXXXXXXXXXXXXXXXXXXXXXXXXXXX-X-X---XXX--XXXXXXXXXXXXXXXXXXXXXXXX------XX--XXXXXXXXXXXXXXXXXXXXXXXX---X--XXXXXX--XXXXXXXXXXXXXXXXXXXXXXXX