-------------------------------------------------------------------------------------------------------------------------------------------------------------------------------------------------------------------------------------------------------------------------------------------------------------------------------------------------------------------------------------
-------------------------------------------------------------------------------------------------------------------------------------------------------------------------------------------------------------------------------------------------------------------------------------------------------------------------------------------------------------------------------------
-------------------------------------------------------------------------------------------------------------------------------------------------------------------------------------------------------------------------------------------------------------------------------------------------------------------------------------------------------------------------------------
-------------------------------------------------------------------------------------------------------------------------------------------------------------------------------------------------------------------------------------------------------------------------------------------------------------------------------------------------------------------------------------
-------------------------------------------------------------------------------------------------------------------------------------------------------------------------------------------#-----------------------------------------------------------------------------------------------------------------------------------------------------------------------------------------
-------------------------------------------------------------------------------------------------------------------------------------------------------------------------------------------------------------------------------------------------------------------------------------------------------------------------------------------------------------------------------------
-------------------------------------------------------------------SSSSCSSSS-------------------------------------------------------------------------------------------------------------#-------------------------------------------------------------------------------------------------------------------------------------------------------------------------------------------
-----------------------------------------------------------------------------------------------------------------------------------------------------------------------------------------#--------------------------------------------------------oo-------------------------o-------------------------------------------------------------------------------------------------------
---------------------------------------------------------------------------------------------------------------------------------------------------------------------------------------#-##SSCSSS------------------------------------------------------SSSSS--------------------------------------------------------------------------------------------------------------SSSSSSS----
---------------------------------------------------------------------------------------------------------------------------------------------------------------------------------------#-##----------------------tt------------------------------------------------------------------------------------------------------------------------------------------------------------------
----------------------------------TT--tt--------T-----------------TT---------------TT------------------------------o---o----------------------------------TT---TT----TT----#-------T---#-##----------------------tt------------------------------------------------------------------------------------------------------------------------------------------------------------------
----------------------------------TT--tt--------TT----------------TT---t-----------TT---------------------------------------------------------------------TT---TT-----T---##-------T-------------------------TT--tt----------------T-------------------------------------------------------------------------------------------------------------------------------------------------
----------------------------------TT--tt--oo----TT------------TT--TT--tt-----#-----TT------------------------------------------#--------------------------TT---TT-----T---##-------T---#--##----------------TT---tt-----------------------------------------------------------------#--#-----------T---------------------------------------------------------#-----TT----------------
-----------------kk---k-g---------TT--tt--------T-----k-------TT--TT--tt----#------TT---------------k-ggg-----k----------------#----------kkkk------------TT---TT----TT---##-------T------##----------ggg---TT---tt---k-k----------------gg------------------------------gg---------#--#-----ggg---TT----g--------------------------------k----------------gk#-----TT----#-----------
XXXX--XXXXXXXXXXXXXXXXXXXXXXXXXX--XX--XX--X-XXXXXXXX----X-XXXXXXXXXXXXXXXXXXXXXXXXXXXXX-XXXXXXXXXXXXXXXXXXXXXXXXXXXXXXXXXXXXXXXXXXXXXXXXXXXXXXXXXXXXXXXXXXXXXXXXXXXXXXXXXXXXXXXXXXXXXXXX-XX--XX-X-XXXXXXXXXX-XX--XXXXXXXXXXXXXXXXXXXXXXXXXXXXXXXXXXXXXX--#--XXXXXXXXXXXXXXXXXXXXXXX-X-XX-XXXXXXXXXXXXXXXXXXXXXXXXXXXXXX--XXXXXXXX-XXXXXXX-XXXXXXXXXXXXXXXXXXXXXXXXXXXXXXXXXXXXX------
XXXX--XXXXXXXXXXXXXXXXXXXXXXXXXX--XX--XX--X-XXXXXXXX----X-XXXXXXXXXXXXXXXXXXXXXXXXXXXXX-XXXXXXXXXXXXXXXXXXXXXXXXXXXXXXXXXXXXXXXXXXXXXXXXXXXXXXXXXXXXXXXXXXXXXXXXXXXXXXXXXXXXXXXXXXXXXXXX-XX--XX-XXXXXXXXXXXXXXX--XXXXXXXXXXXXXXXXXXXXXXXXXXXXXXXXXXXXXX--X-XXXXXXXXXXXXXXXXXXXXXXXX-X-XXXXXXXXXXXXXXXXXXXXXXXXXXXXXXXXX--XXXXXXXXXXXXXXXX-XXXXXXXXXXXXXXXXXXXXXXXXXXXXXXXXXXXXX------