-------------------------------------------------------------------------------------------------------------------------------------------------------------------------------------------------------------------------------------------------------------------------------------------------------------------------------------------------------------------------------------
-------------------------------------------------------------------------------------------------------------------------------------------------------------------------------------------------------------------------------------------------------------------------------------------------------------------------------------------------------------------------------------
-------------------------------------------------------------------------------#o----------------------------------------------------------------------------------------------------------------------------------------------------------------------------------------------------------------------------------------------------------------------------------------------------
------------------------------------------------------------------------------##-----------------------------------------------------------------------------------------------------------------------------------------------------------------------------------------------------------------------------------------------------------------------------------------------------
------------------------------------------------------------------------------##-----------------------------------------------------------------------------------------------------------------------------------------------------------------------------------------------------------------------------------------------------------------------------------------------------
------------------------------------------------------------------------------##-----------------------------------------------------------------------------------------------------------------------------------------------------------------------------------------------------------------------------------------------------------------------------------------------------
------------------------------------------------------------------------------##-o-------------------------------------------------------------------------------------------------------------------------------------------------------------------------------------------------------------------------------------------------------------------SS----------------------SSSSCSS-
-----------------------------------------------------------------------------------------------------------------------------------------------------------------------------------------------------------------------------------------o-------------------------------------------------------------------------------------------------------------------------------------------
-----SSSSSSS---------#--------##---------SSS-----------------------------------------------S-------------------------------------------------------------------------------o-----------------SSCSS---------------------------------------------------###--S--------------SS--S-------------------------------------------------------------------------------------------------------
------------o-------##------####-----------------------#-----------------------------------------------------------------o-------------------------------------------------o-------------------------------------------------------------------------###---------------------------o-----------o---------------o-------------------------tt------------------------------------------
--------------------###---#-####----------------------##---------------------------------------------------------------------------------------------TT-------------------------------------------------------##-------------------------------------###---------------------------------------------------------------------------------tt----------------------------------oo------
------------------#-###---#-####---------------------###---------------------------o--------------------------------------------TT-------------------TT-------------------------------------------------------##-----TT----------------------------#-###-----------------------------------------------TT--------------------------------tt--------------TT--------------------------
--------oo--------#-###---#-####--------------------####-----------------------------------------------------------t------------TT-------------------TT--------------------------------------------------#---###-----TT----------------------------#-###-----------------------------------------------TT------------------------------#-t---------------TT--------------------------
------------------gg###---#-####--------------------#-##----------------------------------------------k-k----------t------------TT--------kkk-X-g----TT------------------------------------------------kk#---#-#-----TT-------k---ggg--------------#-#-#-----------------------------------------------TT----------------ggg----k----#-#---------gggg----TT------------------k----g--
---X-X--------XXXXXXXXXXX-X-XXXXXXXXXXX-XXX-----XXX-X-XXXXX-XXXXXXXXXXXXXX--X-XXXXXXXXXXXXXXXXXXX-XXXXXXXXXXXXXX--XXX-X-X-XXXXXXXXXXXXXXXXXXXXXXXXXXXXXXXXX-XXXXXXXXXXXXX-X-X-XXXXXXXXXXXXXXX---XXXXXXXXXXXX-X-XXXXXXXXXXXXXXXXXXXXXXXXXX-X-XXXXXX-X-X-XX--XXXXXX-X-XXXXX---X-X------XXXX-X-X-X--XXXXXXXXXXXXXX--XXXXXXXXXXXXXXXXXXXXX-XXXXXXXXXXXXXXXX--XXXXXXXXXXXXXXXXXXXXXXXXXXXX
X--X-X--------XXXXXXXXXXXXXXXXXXXXXXXX--XXX-----XXXXXXXXXXX-XXXXXXXXXXXXXX--X-XXXXXXXXXXXXXXXXXXX-XXXXXXXXXXXXXX--XX--X-X-XXXXXXXXX-XXXXXXXXXXXXXXXXXXXXXXX-XXXXXXXXXXXXXXX-XXXXXXXXXXXXXXXXX---XXXXXXXXXXXXXX-XXXXXXXXXXXXXXXXXXXXXXXXXX-X-XXXXXXXXXX-XX--XXXXXX-X-XXXXX---X-X------XXXX-X-X-X--XXXXXXXXXXXXXX--XXXXXXXXXXXXXXXXXXXXXXXXXXXXXXXXXXXXXX--XXXXXXXXXXXXXXXXXXXXXXXXXXXX