-------------------------------------------------------------------------------------------------------------------------------------------------------------------------------------------------------------------------------------------------------------------------------------------------------------------------------------------------------------------------------------
-------------------------------------------------------------------------------------------------------------------------------------------------------------------------------------------------------------------------------------------------------------------------------------------------------------------------------------------------------------------------------------
-------------------------------------------------------------------------------------------------------------------------------------------------------------------------------------------------------------------------------------------------------------------------------------------------------------------------------------------------------------------------------------
-------------------------------------------------------------------------------------------------------------------------------------------------------------------------------------------------------------------------------------------------------------------------------------------------------------------------------------------------------------------------------------
-------------------------------------------------------------------------------------------------------------------------------------------------------------------------------------------------------------------------------------------------------------------------------------------------------------------------------------------------------------------------------------
-----------------------------------------------------------------------------------------------------------------------------------------------------------------------------------------------------------------------------------------------------------------------------------------------------------------------------o-------------------------------------------------------
------------------------------------------------------------SSSCSSS-----------------------oo---------------------------------------------------------------------------------------------------------------------------##-------------------------------------------------------------------------------------------------------------------------------------###--------------------
-----------------------------------------------------------------------------------------------------------------------------------------------------------------------------------------------------------------------##------------------------------------------------------------------------------------------------------------------------------------####--------------------
-----------------------------------------------------------------------------------------------------------------------------------------------------------------------------------------------------------------------##----------------------------------------------------------------------------------------------------------------------------------#-####--------------------
---------------------------------------------------------------------------------------------------------------------------------------------------------------------------------------------------------------------#-#---------------------------------------------------------------------------------------------------------o-------------------------#-####--------------------
-----------------------------TT------------------##--------------o------------##------------oo---------------------------------------------------------------------------------------T-----------TT------------------#-#---------------------TT--t--------T------------------#-----------------------------------------------------------------------------#-####--------------------
-----------------------------TT---tt------------##-----------#----------------##----------------------------------------------------------------------------------------------------TT-----------TT------------------------------------------TT--t-------TTT---------------#-#----------------------------------------------------------------------------##-#-##--------------------
-----------------------------TT---tt----------#-#-#--------#-#-------------#-##----#-----------------------------------------------------------------------------------TT------------T-----------TT----------------#-------------------------TT--g-------TTT-------T-------#-#-------------TT--------------------TT--------------------------------------###-#-#--------------------X
--#-------------kk-----------TT---tt--------gg#-#-#kkkk--k---#-k--------#-#--##--k-#-----------------k-------------------------gggg-----------ggg---------------gg-----TT------------T-----kk#---TT-----k-k--------#-#-----------------------TT--ggg-----TT-------T------gg#-#-------------TT---------k------gg--TT-k----------------------k---gg-----ggg###-###-------kk---------XXX
XXXXXXXXXXXXXXXXXXXXXXX-XXXXX-XX--XXXXXXXXXXXXX-XXXXXXXXXXXXXXXXXXXXXXXXXXXXXXXXXXXXXXXXX-XXXXXXXXXXXXXXXXXXXXX-XX--X-X-XXXXXXXXXXXXXXX-X-XXXXXXXXXXXXXXXXXX--XXXXXXXX-XX--XXXXXXXXXXXXXXXXXXXXXXXXXXXXXXXXXXXXXXXXXXXXXXXXXX-XXXXXXXXXXXXXX-XXXXXXXXXXXXXXXXXXXXXXXXXXXXXXXXXXXXXX-XXXXXX-XX--XXXXXXXXXXXX-XXXXXXXXXXXXXXXXX---X----XXXXXXXXXXXXXXXXXXXXXXX-XXXXXXXXXXXXXXXXXXXXXXXX
XXXXXXXXXXXXXXXXXXXXXXX-XXXXX-XX--XXXXXXXXXXXXXXXXXXXXXXXXXXXXXXXXXXXXXXXXXXXXXXXXXXXXXXX-XXXXXXXXXXXXXXXXXXXXX--X--X-X-XXXXXXXXXXXXXXX-XXXXXXXXXXXXXXXXXXXX--XXXXXXXXXXX--XXXXXXXXXXXXXXXXXXXXXXXXXXXXXXXXXXXXXXXXXXXXXXXXXX-XXXXXXXXXXXXXXXXXXXXXXXXXXXXXXXXXXXXXXXXXXXXXXXXXXXXX-XXXXXX-XX--XXXXXXXXXXXX-XXXXXXXXXXXXXXXXX--XX----XXXXXXXXXXXXXXXXXXXXXXXXXXXXXXXXXXXXXXXXXXXXXXXX