-------------------------------------------------------------------------------------------------------------------------------------------------------------------------------------------------------------------------------------------------------------------------------------------------------------------------------------------------------------------------------------
-------------------------------------------------------------------------------------------------------------------------------------------------------------------------------------------------------------------------------------------------------------------------------------------------------------------------------------------------------------------------------------
-------------------------------------------------------------------------------------------------------------------------------------------------------------------------------------------------------------------------------------------------------------------------------------------------------------------------------------------------------------------------------------
-------------------------------------------------------------------------------------------------------------------------------------------------------------------------------------------------------------------------------------------------------------------------------------------------------------------------------------------------------------------------------------
----------------------------------------------------------------------------------------------------------SSSCS----------------------------------------------------------------------------------------------------------------------------------------------------------------------------------------------------##----------------------------------------------------------------
-------------------------------------------------------------------------------------------------------------------------------------------------------------------------------------------------------------------------------------------------------------------------------------------------------------------##----------------------------------------------------------------
-------------------------------------------------------------------------------------------------------------------o-SS------------------------------------------------------------------S---------------------------------------------------------------------------------------SSSSCSS-------------------------####--SSS-----oo-----------------------------------SSSCSSSSSSS------
-----------------------------------------------------------------------------------------------------------------------------------------------------------------o------------------------------------------------------------------------------------------------------------------------------o----------------###---------------------o-------------------------------------------
------------------------------------------------------------------------------------------------------------------------------------------------------------------------------------------------SSSSS------------------------------------------------------------------------------------------------------------##------------------------------------------SSSSSS------------------
---------------------------------------------------------------------------------------------------------o-----------------------------------------------------------------------------------------------------------------------------------------------------------------------------------------------------#-##------------#-----------------------------------------------------
---------------------------------TT---tt---------------TT----------------------------------------------------------------------------------------------------------------#oo----------TT-----------------T---T--------------------------------------------------------T----------------------------------------#-##------------#---------------------TT------------------------------
---------------------------------TT---tt---------------TT-------oo---TT----------------------------------------------------------------------------#--------TT-----------##-----------TT-----------------TT--t---------------o---------------------------------------TT----------------------------------------####-----------#------TT--------T-----TT------------------##----------
-------------------o--------TT---TT---tt---------------TT------------TT--------#------#-------------------------------------#----------------------#--------TT----------###-----------TT---t-------------TT--t---------#-----------------------------#---------------TTT---TT--------------------------------#-####---------------------------TT------T----------------#-#-----------
--------------ggg-#----k----TT---TT---tt---------------TT------------TT-----kkk#-k----#---ggg------------------k-----------------------gg----------#--------TT-----ggg####----ggg-----TT---t-------------TT--t-k----k--#--k------kk--k-----------kk#-#---------------TT----TT----------------------------kk--#-#-##--------g-#----------------TT---k--T--------tt----------#---------
XXXXXXXXXXXXXXXXX-XXXXXXXXXXXXXXXXXX--XXXXXXXXXXXXXXXXXXXXXXXXXXXXXXXXXXXXXXXXXXXXXXX-X-XXXXXXXXXXXX------XXXXXXXXXXXXXXXXX-X-XXXXXXXXXXXXXXXXXXXXXXXXXXXXXXXXXXXXXXXXXXXXXXXXXXXXXXXXXXXXXXXXXXXXXXXXXXXXXXXXXXXXXXXXXXXXXXXXXXXXXXXXXXXXXXXXXXXXXXXXXXXXXXXXXXXXXXXXXXXXXXXXXXXXX-X-XXXXXXXXXXXXXXXXXXXXXXXX-XXXXXXXXXXXXXXXXXXXXXXXXXXXXXXXXXXXXXXXXXXX-XX--X-XXXXXXX-XXXXXXXXXXXX
XXXXXXXXXXXXXXXXXXXXXXXXXXXXXXXXXXXX--XXXXXXXXXXXXXXXXXXXXXXXXXXXXXXXXXXXXXXXXXXXXXXX-XXXXXXXXXXXXXX------XXXXXXXXXXXXXXXXX-XXXXXXXXXXXXXXXXXXXXXXXXXXXXXXXXXXXXXXXXXXXXXXXXXXXXXXXXXXXXXXXXXXXXXXXXXXXXXXXXXXXXXXXXXXXXXXXXXXXXXXXXXXXXXXXXXXXXXXXXXXXXXXXXXXXXXXXXXXXXXXXXXXXXXXXXXXXXXXXXXXXXXXXXXXXXXXXXXXXXXXXXXXXXXXXXXXXXXXXXXXXXXXXXXXXXXXXXXXXXXXXXX----XXXXXXXXXXXXXXXXXXXX