------------------------------------------------------------------------------------------------------------------------------------------------------
------------------------------------------------------------------------------------------------------------------------------------------------------
------------------------------------------------------------------------------------------------------------------------------------------------------
------------------------------------------------------------------------------------------------------------------------------------------------------
------------------------------------------------------------------------------------------------------------------------------------------------------
-----------oo---------oo------------------------------oooo---------------------------oo-------------------------------------ooo---------oo--oo--------
-----------------%%%%%%%%%%--------------------------%%%%%%-------------------------------------SS----------------------------------------------------
------------------||--||||----------------------------||||------------oo------------------------------------------------------------------------oo----
-------------%%%%-||-|||||----------------------------||||----oo-------------------------------------------------------g------------S-----------------
-----%%%%-----||--||-|||||----------------------------||||-----------------------------------------------------------%%%%%%o--------------------------
------||------||--||-|||||-----%%%%----####-----------||||----------------------SSS-----------------------------------||||----------------o-----------
------||------||-|||||||||-------|-----####------%%---||||------------------------------------------------------------||||----------------------------
------||---%%%%|-|||||||||------------#####-----------||----------------%%%%------------------------------------------||||----------------------------
------||----||--||||||||||-------|----#####-----------||----------------%||-------------%---------------%%------------||||-------------------------#--
------||----||--||||||||||----XXXXXXXXXXXXXXXXXXXXX---||-XXXXXXXXXX-----|||----%---%%%-|--------%%%-----%%%----%%----|||||-------%%%--XXXXXXXXXXXXXXXX
------||----||--||||||||||----XXXXXXXXXXXXXXXXXXXXX---||XXXXXXXXXXX-----|||----%----|--|---------|------||||----|----|||||--------|----XXXXXXXXXXXXXXX