------------------------------------------------------------------------------------------------------------------------------------------------------
------------------------------------------------------------------------------------------------------------------------------------------------------
------------------------------------------------------------------------------------------------------------------------------------------------------
------------------------------------------------------------------------------------------------------------------------------------------------------
-----------------------------------------------#-------------------------------%%---------------------------------------------------------------------
-------ooo----------oo-------------------------#----------oo------oo------------||%%%--------------------------ooo----------------------------oo------
------------------------SS-------------------#-#--------------------------------||||---------------------------%%%%%-------------------------%%%%-----
---------------------------------------------#-##-------------------------------||||------------oo--------------|||---------|------------------|------
---------------------------------------------%%%%-----SS------------------------||||---------%%%%%%%------------||||--------------------------||------
---------------%%%%---%%%%--|-|o-----#-------||||----------------------%%%%-----||||----------|||||------%%%%---||||-------#|-----------------|-------
-----%%%%%%%----||--%%%|||--||%%%%--###-------|||-------SS--------SS%---||------||||----------||||--------||----||||-------##----------------%%%%-----
------|||||-----||---|||||--|||||---###-------|||-------------------|---||------||||----------||||--------||----||||--------#-----------------||------
------|||||-----||---|||||--|||||---###-------||||-------------------%--||-%----||||----------||||--------||----||||--------------------------||------
------|||||-----||---|||||--||||||--##--------||||----------------------|||-----||||----------||||--------||----||||--------|-----------------||------
----%-|||||----%%%%--|||||--||||||--XXXXXXXXX-||||---------------------||||-----||||----------||||--------||----||||---|---%%%%XXXXXXXXXXX---%%%%-XXX-
------||||------||---||||---||||||--XXXXXXXXX-||||--------------------|||||-----||||----------||||--------||----||||---|----||XXXXXXXXXXXX----||--XXXX