------------------------------------------------------------------------------------------------------------------------------------------------------
------------------------------------------------------------------------------------------------------------------------------------------------------
------------------------------------------------------------------------------------------------------------------------------------------------------
------------------------------------------------------------------------------------------------------------------------------------------------------
------------------------------------------------------------------------------------------------------------------------------------------------------
--------------oo--------%%---%-----------o--o-----------------------oo--------------------------------------------------------------------------------
------------%----%%%%%--------|%%%-----------%-%%%%-------------%%%--------%%%%--------------------------------%%%%------------------%%%%%%-----------
------------------|||---------||-|-----------|||||---------------|----------||--------------------------------oo||||%--R--ooo-------%%||||%%%---------
------------------||||--------||||-----------|||||--------------------------||----------%%%------------------%%-||||-----%%%%-------|||||||-----------
------------------||||--------||||-----------|||||---------------|----------||-------%%%%|--------------------|||||||-----||--------||||||||----------
-----------%%%%----|||-----%%%%|||-----------|||||-------------%%%%-%%%%%---||----oo--||||--%%%S--------------|||||||-----||||------||||||-|----------
------------||-----|||------||||||----%%-----|||||---------------|---|||----||--------||||---|----------------||||||||----||||------||||||-|----------
-------------|------||------||||||----|||----|||||---------------|----||----||--------||||---|----------------||||||||----||||------||||||-|----------
------------||------||------||||||----|||-----||||--o------------|--|-||----||-o------||||-----------%%%%%----||||||||--o-||||------||||||-|----------
XXXXXXXXXXXX||------||----%-||||||----|||-----||||---%-%%%%%%%%%%|--||||----||--------||||------------||||----||||||||----||||------||||||------|X--XX
XXXXXXXXXXXX||------||------||||||----|||-----||||------%%%%---||X--||||----||--------||--------------||||----||||||||-----|||------||||||------||--XX