------------------------------------------------------------------------------------------------------------------------------------------------------
------------------------------------------------------------------------------------------------------------------------------------------------------
------------------------------------------------------------------------------------------------------------------------------------------------------
------------------------------------------------------------------------------------------------------------------------------------------------------
------------------------------------------------------------------------------------------------------------------------------------------------------
------oo-----%%-------------------------------------------oo---------------oo-------------------------------oo-----------------%%%%%%-----------------
--------------------------------------------------------------------------------------------------------------------------------||||----S-------------
--------------------------------------------------------------------------------------------------------------------------------||||------------------
-----##-------------------------------------------------------------------SS-------------------------------------------------%%%%%%|------------------
-----##-----------------------------------------------ooo---------------------------------------------------------------------||||||--||--------------
----###---------------%%%----------------%%%%%-----%%%%-------------------------#--------%%%%%-------------%%%%---------------||||||--||--------------
----###---------------||------------------||--||%---||--------------------------#---%%%---|||---------------||----------------||||||--||--------------
----###---------------||------------------||--||----||--------------------------#---||----|||---------------||-------------%--||||||--||--------------
-----##---------------||---------%%%%%----||--||----||-----------------------####---||----|||---------------||-----o---%%%%%--||||||--||-----------#--
XXXXXXX----%%%%%%%%%--|||---------|||---%-||%-||----||X-XXXXXXXXXXXXXXXXXXXXXXXXX---||----|||-------------%-||----------|||---||||||--||||--------XXXX
XXXXXX------|--%%||---||-----------||-----||--||----||---XXXXXXXXXXXXXXXXXXXXXXXXX-|||----|||---------------||----------|||---||||||--|||X--------XXXX