------------------------------------------------------------------------------------------------------------------------------------------------------
------------------------------------------------------------------------------------------------------------------------------------------------------
------------------------------------------------------------------------------------------------------------------------------------------------------
------------------------------------------------------------------------------------------------------------------------------------------------------
-----------------------------------------------------------------------------------------------------------------------------------g------------------
-------------------------------------------------------------o----oo--ooo------------------------R----------oo------------oo-----X%%%-----------------
-----------------##%%##%%%%--------####%%%%%%%#----------------------%%%%--------------------------%%%%------------------%%%%-----||------------------
-----------------########----------############-------------SS--------||----------------------------||--------------------||------||------------------
-----SSS------S--#########--------#############-----------------------||----------------------------||------------oo------||------||------------------
----------------##########-------##############-----------------------||----------------------------||--------------------||------||------------------
----------------##########-------##############-------SS-----------%%%%|-------------------%%--%%%%-|%--------------------%%%%%---||------------------
----------------##########------###############---------------------||||------------------------||--||--------------------||||----||------------------
-----%---------###########-------##############---------------------||||------------------------||--||--------------------||||----||-----------------X
-----%%%%------###########-------##############---------------------||||---------------------%--||--||--------------------||||--oo||---%%%%--------#-X
------||XXXXXXXXXXXXXXXXXXXXXXXXXXXXXXXXXXXXXXXXXXXXXXXXXXXXXXX---%%%|||---%%%%%%%%XXXXXXXXXXXX-||--||---XXXXXXXXXXXXXX---||||-%%%%%%%--||---XXXXXXXXX
------|||XXXXXXXXXXXXXXXXXXXXXXXXXXXXXXXXXXXXXXXXXXXXXXXXXXXXXX----|||||----%--%%%%XXXXXXXXXXXX-|||-||---XXXXXXXXXXXXXX---||||---|-|||--||---XXXXXXXXX