------------------------------------------------------------------------------------------------------------------------------------------------------
------------------------------------------------------------------------------------------------------------------------------------------------------
------------------------------------------------------------------------------------------------------------------------------------------------------
------------------------------------------------------------------------------------------------------------------------------------------------------
---------------------------------------------------------------------------------------------------------------------------------------------g--------
---------------------------o------oo-------------------------ooo-----------R-----------------------oo--------------------------------------%%%%%------
----------------------------------%--------------------------------------------g----------------%%%%%------------%%-------------------------|||-------
-----------------------------------|-----------------------------------------%%%%---------------||||-------------##-------------------------||||------
----------------------SS--SS-------|------------------------------------------||------%-%-------||||--------------#-------------------------||||------
------%%%--------------------------#------------------------------------------||-----%%%--%%%---||||--------------|-------------------------||||------
------||---------------------------#--------------|----%%%%%%%%%%%%--%%%%--%%%||------||--|||---||||-----------%%%%%%----------%%-----------||||------
------||--------------------------##--------------||-----|-|||||||----||----|-||----|-||--||||--||||------------||||------------------------||||------
------||--------------------------###--------%----||--------||||||----||----||||-|--|-||--||||--||||------------||||------------#-----------||||------
------||--------oo----------------#####---%%%%----||-----|-|||||||----||----||||-|--|||||-||||--||||-|----------||||------------#-----------||||---#--
------||------------%%--XXXXXXXXXXXXXXXXX--|||----||-----|--||||||----||----||||||--||||||||||--||||||--XXXXX-%-||||--XXXXXXXXXXXXXXX%%%%---||||---XXX
------||------------|---XXXXXXXXXXXXXXXXX--|||----||-----|--||--||----||----||||||--||||||||||--||||||----XXX---||||--XXXXXXXXXXXX-X-||-----||||---XXX