------------------------------------------------------------------------------------------------------------------------------------------------------
------------------------------------------------------------------------------------------------------------------------------------------------------
------------------------------------------------------------------------------------------------------------------------------------------------------
-------o----------------------------------------------------------------------------------------------------------------------------------------------
-----------g------------------------------------------------------------------------------------------------------------------------------------------
---------%%%%%%%%-----------------------------o----R--oooo------------------------------o-----------------o-----------oo----------------oo------------
----------|||||----%%%%------------------%%%---------%%%%%%---%-%----------------------------------------%%%%%%---------------------------------------
----------|||||-----||-------------------%|-----------||||------------------------------------------------||||----------------------------------------
----------|||||-----||-------------SS-----|||---------||||-----|------------------------------------------||||------S---------------------------------
-----------|||------||----oo--------------|||---------||||----%%%-----------------------------------------||||----------------------------------------
------SS----|-------||---%%%%-------------|||---------||||----||------oo---%%%%%--%%%---------------------||||--------------oo------------------------
--------------------||----||--------------|||---------||||----||------------|||------------##-------------||||------------------------------%%%%%-----
--------------------||----||------------%%%%%---------||||-|--||------------|||------------#--------------||||-------------------------------|||------
--------------------||--o-||----oo-------||||-|-------||||||--||------------|||-------oo---###-----ooo----||||------------------------------||||------
------------------%%%%%-%-||-------------|||--|-------||||||--%%%%%-------%-|||-------XXXXXXXXXXX-XX%%%---||||--XXXXXXXXXXX---XXXXXXXXXX----||||------
-------------------|||----||-------------|||--||------||||||---|||----------|||-------XXXXXXXXXXXX-%||----||||--XXXXXXXXXXX---XXXXXXXXX-----||||------