------------------------------------------------------------------------------------------------------------------------------------------------------
------------------------------------------------------------------------------------------------------------------------------------------------------
------------------------------------------------------------------------------------------------------------------------------------------------------
------------------------------------------------------------------------------------------------------------------------------------------------------
------------------------------------------------------------------------------------------------------------------------------------------------------
---------------------------------------oor--------------------------------------------------------o-------------oo------------oo----------------------
--------%%----------------------------%%%%%%-----------------------------------------%%%%------------------------%%%%---------------------------------
------o---------------------------------||||oo----------------------oo----------------------------%%%%%%----------||----------------oooo--------------
-----%%%%%------------------------------||||%%%%-----------------%%%%---SS-------S----||-----------|||------------||----------------%%%%%%------------
------|||---------------oo--------------|||||-|-------------------||------------------||-----------||||-----------||-----------------|||--------------
------||-----------------%%%------------|||||-|-------------%%%---||-----%%%%%%---%%%-||----------||||---------%%%%|-----------------|||--------------
------||------------------|-------------|||||---------------||----||------||||----||--|-----------|||||---------||||------------------||--------------
------||------------------|-------------||||||--------------||----||------||||----||--|---------%-||||||--------||||------------------||--------------
------||----------oo---ooo||------------||||||--------------||----|||-----||||----||---|-%%%------||||||-%%%%---||||------------------||-----------#--
XXXXXX||--%%---%%%%%%--%%%%|-------XXX%%||||||XXXXXXXXXXX---||----||||----||||--%%||---|--||------||||||--||--%-||||---------%%%%-----||-----%%---XXXX
XXXXXX||---------|||----|-||-------XXXXX||||||XXXXXXXXXX----||----||||----||||----||-|----||------||||||--|-----||||---------|%||-----||-----%----XXXX