------------------------------------------------------------------------------------------------------------------------------------------------------
------------------------------------------------------------------------------------------------------------------------------------------------------
------------------------------------------------------------------------------------------------------------------------------------------------------
------------------------------------------------------------------------------------------------------------------------------------------------------
------------------------------------------------------------------------------------------------------------oo----------------------------------------
------------------oo-----ooo%-------------------------------------------------------------------------------------------------------------------------
-------------------------%%%%---S-------------------------%----------#%----------%%%%-----------##-------------SS------------------#----------SS------
-----------%%%%-----------||-------------------------%%%%%-----------#------------||------------##-----------SS--------------------#------------------
----------||||------------||---------------SS--------%||||-----------#-----------|||------------##---------------------------------#------------------
--------%|||||------------||--------------------------||||-----------#-----------|||-----------###------------------------------oo------------oo------
--------||||||------------||--------------------------||||---------%%%----------||%%%%%-------####---------------------------%%%%--------------%------
--------||||||------------||------%%------------||----||||----------||----------||||||--------###-----------------------------||----------------------
-----%%-%|||||------------||------||------------||----||||----------||----------||||||--------###-----------------------------||---------------|------
------||-|||||------------||------||------------||%---||||-%%%%-----|---------%-||||||--------###-----------------------------||-------------%%|---#--
------||--||||---%%----%%-||------||------XXXXX-||----||||--|-----XXXXXXXXXX---%%|||||----XXXXXXXX-XX-----XXXXXXXXX-%%%%%%----||--XXXXXXXX----||--XXXX
X-----||--||||------------||------||------XXXX--||----||||--||----XXXXXXXXXX---|||||||----XXXXXXXXX-X-----XXXXXXXXXX-%%%%%----||---XXXXXX-----||-XXXXX