------------------------------------------------------------------------------------------------------------------------------------------------------
------------------------------------------------------------------------------------------------------------------------------------------------------
------------------------------------------------------------------------------------------------------------------------------------------------------
-------------R----------------------------------------------------------------------------------------------------------------------------------------
-----------------------------------------------------------------g-------------------------------------------------X-----------------g----------------
--------------------oo----------oo-------R-------------------%%%%%%---------------oo---oo%%%%%---------o-------------------------%%%%%%---------------
--------------------------------------------SSS---------------||||------------------------||--|%%--------------------------%%%%---||||----------------
-----------------------------%------------------------oo-|----||||-----------%------------||--||---------------------------%||----||||----------------
-----------------------------------------------------%%%%%----||||-------------------%%%%|||--||----------------------------||-%%-||||---%%%----------
----------------------------|------o------------------||||---%%|||------------------||||||||--||----------------------------||--|-||||---------#------
----------------------------|%%%%%%%%%----------------||||----||||---------%%%%%%---||||||||--||-----%----------S--------%|-||--|-||||----|----#------
----------------------------||||--|||----------%%%%---||||----||||----------||||----||||||||--||------||------------------||||--||||||-----|---#------
----------------------------||||--|||-----------||----||||----||||-------%%%||||----||||||||--||------||------------------||||--||||||-----|---#------
----------------------------||||--|||-----------||----||||----||||--------||||||----||||||||--||--%o--||------------------||||--||||||----%%%--%-o----
X------XXXXXXXXXXXXXX----|--||||--%%%%%--XXXXXX-||----||||----||||--------||||||----||||||||--||----%%%%%-%%%%%%%%%%%%%%%-||||--||||||---%%|--%%%XX-XX
X-----XXXXXXXXXXXXXXX----|--||||--||||---XXXXXX-||----||||----||||--------||||||----||||||||--||------||--%%--%-%|-%%%||--||||--||||||----||----|XX-XX