--------------------------------------------------------------------------------------------------------------------------------------------------------------
--------------------------------------------------------------------------------------------------------------------------------------------------------------
--------------------------------------------------------------------------------------------------------------------------------------------------------------
S------SSSSSSSSSSSSSSSSSSSSSSSSSSSSSSSSSSSSSSSSSSSSSSSSSSSS------------SS-------SSSSSSSSSSSSSSSSSSSSSSSSSSSSSSSSSSSSSSSSSSSSSSSSSSSSSSSSSSSSSSSSSSSSSSSS------
S-----------SS--SSSSS--------------------------------------------------------------S----------------SSSSSSSSSS------------------------------------------------
S-----------SS---SSSS--------------------------------------------------------------S----------------SSSSSSSSSS------------------------------------------------
S-----------SS----SSS-----------------------------------------------------------S--S----------------SSSSSS----------------------------------------------------
S-----------SS------------------------------------------------------------------S-------------------SSSSSS----------------------------------------------------
S---------S-SS---S--------------------------------------------------------------SSS----------------------------------------SSSS-------------------------------
S---------SoSS---S--------------------------------------------------------------S-SS-----------------Soo---S---------------SSSSS---S-S------------------------
S---------SSSS-----------------------------------------------SS-------------------SSSS-------g-#-----SSSSSSS----SSSSSSSS----SSS----SSS---------------SSS------
S--------------------------------------------------------------------------#-#---------------#-#---------------------------------------------#----------------
S------------------gS#--------------SS----------------T------------------g-#-#-------------g-#-#-S---------------------#---------------------#-#S-------------
S--------------g---#-#-----------T-------------g------TT-------S------g-g#-#-#-------------#-#-#--------kk-----------#-#--------kk---------#-#-#-------g-g----
XXXXXXXXXXXXXXXXXXXXXXXXXXXXXXXXXXXXXXXXXXXXXXXXXXX----XXXXX--XX---XXXXXXXXXXXXXXXXXXXXXXXXXXXXXXXXXXXXXXXXXXXXXXXXXXXXXXXXXXXXXXXXXXXXXXXXXXXXXXXXXXXXXXXXXXX
XXXXXXXXXXXXXXXXXXXXXXXXXXXXXXXXXXXXXXXXXXXXXXXXXXXX---XXXXX--XX---XXXXXXXXXXXXXXXXXXXXXXXXXXXXXXXXXXXXXXXXXXXXXXXXXXXXXXXXXXXXXXXXXXXXXXXXXXXXXXXXXXXXXXXXXXX