--------------------------------------------------------------------------------------------------------------------------------------------------------------
--------------------------------------------------------------------------------------------------------------------------------------------------------------
--------------------------------------------------------------------------------------------------------------------------------------------------------------
SSSSSSSSSSSSSSSSSSSSSSSSSSSSSSSSSSSSSSSSS---------SSSSSSSSSSSSSSSSSSSSSSSSSSSSSSSSSSSSSSSSSSSSSSSSSSSSSSSSSSSSSSSSSSSSSSSSSSSSSSSSSSSSSSSSSSSSSSSSSS----------
--------------------------------------------------------------------S---------------------------------------------SSSSSS--SS----------------------------------
--------------------------------------------------------------------S---------------------------------------------SS--SS--SS----------------------------------
----------------------------------------------------------------------------------------oooooo--oo---oo------------SSSSS--SS-----------------o----------------
-------------------------------------------------------------------------------------------------------------------SSSSS--SS----------------------------------
----------------------------------------------------------------------------------------SSSSSS-SSSSSSSS--------S--SS--SS-------------------SSSSSSS------------
--------------------------SSoS------------------------------og--------------------------SSSSSS--SS--SS---------SooSS--SS-------------------S-S----------------
-----------@QQQ-------SS--SSSS---------#-----------#-###----SS----SS---------@QQ----------S-SS--SS-------------SSS-------------S-#-#-#---#-#------------------
S------T-----------------------------#-#---------#-#-###-----------------------------------------------------------------------#-#-#-#-#-#--------------------
S--------------------------------#-#-#-#-----S-#-#-####----------------------------g-#-#-#---------------------------------------#-#-#-#-#-#------------------
S----------------g-------------g-#-#-#-#---S-#-#-#-#-##--------g-------g-#-------#-#-#-#-#-----------g-g-S--------kk---------#---#-#-#-#-#-#------------------
XXXXXXXXXXXXXXXXXXX----XXXXXXXXXXXXXXXXXXXXXXXXXXXXXXXXXXXXXXXXXXXXXXXXXXXXXXXXXXXXXXXXXXXXXXXXXXXXXXXXXXXXXXXXXXXXXXXXXXXXXXXXXXXXXXXXXXXXXXXXXXXXXXXXXXXXXXX
XXXXXXXXXXXXXXXXXXXX---XXXXXXXXXXXXXXXXXXXXXXXXXXXXXXXXXXXXXXXXXXXXXXXXXXXXXXXXXXXXXXXXXXXXXXXXXXXXXXXXXXXXXXXXXXXXXXXXXXXXXXXXXXXXXXXXXXXXXXXXXXXXXXXXXXXXXXX