--------------------------------------------------------------------------------------------------------------------------------------------------------------
--------------------------------------------------------------------------------------------------------------------------------------------------------------
--------------------------------------------------------------------------------------------------------------------------------------------------------------
S---SSSSSSSSSSSSSSSSSSSSSSSSSSSSSSSSSSSSSSSSSSSSSSSSSSSSSSSSSSSSSSSSSSSSSSSSSSSS-----------SSSSSSSSSSSSSSSSSSSSSSSSSSSSSSSSSSSSSSSSSSSSSSSSSSSSSSSSSSSSS------
S-------------------SSS---SS-------------------------S--SS---------S-S----------------------------------------------------------------------------------------
S-------------------SSSS---S---------------------S---S--SS---------SoS--------------------------------------------------------------------------------S-------
S---------------------SS------------------------SS------S----------SSS---------------------------------SSS-------------------S------------------------S-------
S----------------S----SS------------------------SS-------------------------------------------------------S-------------------S-S------------------------------
S---------------SS----SS---------------------------------------------------------------------------------S--------------------------------------SS----S-SS----
S---------------------SS---------------------------------------------------------------------------------SoS------------------------------------------ooS-----
S------------------SS-SS-SS----------------------------------------------------#####-###-----------------SSS-----------#------------------------------SSS-----
S----------------------------------------------------------------------------#-#########-#---------------------------#-#---TT-------------TT------------------
S------------S--------------------------------------------------TT--------##-###########-#-#-------------------S-----#-#----T---TT-----g-#-#-#----------------
S--------------------------#---------#-----------g-#-------g-g--T--------###-###-#-#--#--#-#-----k------------SS---###-#--------TT---#-##--#-#----------------
S-X----XX---XX--XXXXXXXXXXXXXXXXXXXXXXXXXXXXXXXXXXXXXXXXXXXXXXXXXXXXXXXXXXXXXXXXXXXXXXXXXXXXXXXXXXXXXXXXXXXXXXXXXXXXXXXXXXXXXXXXXXXXXXXXXXXXXXX----XXXXXXXXXXX
S--X---XXX--XX--XXXXXXXXXXXXXXXXXXXXXXXXXXXXXXXXXXXXXXXXXXXXXXXXXXXXXXXXXXXXXXXXXXXXXXXXXXXXXXXXXXXXXXXXXXXXXXXXXXXXXXXXXXXXXXXXXXXXXXXXXXXXXXX----XXXXXXXXXXX