--------------------------------------------------------------------------------------------------------------------------------------------------------------
--------------------------------------------------------------------------------------------------------------------------------------------------------------
--------------------------------------------------------------------------------------------------------------------------------------------------------------
S-----SSSSSSSSSSSSSSSSSSSSSSSSSSSSSSSSSSSSSSSSSSSSSSSSSSSSSSSSSSSSSSSSSSSSSSSSSSSSSSSSSSSSSSSSSSSSSSSSSSSSSSSSSSSSSSSSSSSSSSSSS--SS-SSSSSSSSSSSSSSSSSSSS-S----
S-----------------SS----SS--SS--SSSS--SS--------------------------------------------------------------------------------------------------------S-------------
S-----------------SS----SS--SS--SSSS--SS----------------------------------------------------------------------------------------------------------------------
S----------------------SSS--SS---S-S--SSoo----------oo--SS---SSS-------------------------------------------------------------------------------------o--------
S------------------------S--SS---S-S--------------------SS----------------------------------------------------------------------------------------------------
S------------------------S---S-S-SSS--SSSSSSSS-----SSS--SS-----------------------------------------------------------------------------------------S--SS------
S------------------------S---S-S---S--SSSSSSSS----SSSS--SS---------------------------------------------------------------------------------------S-SooSS------
S-------SSSSSSSS-SSS--SSSS---SSSS----SS----SSS--SSSSSS--SS-------------#-T---------T---------------------------S-------SSSSS-SSS------TT--------SS-SSSS-------
S-------------------------------------------SS-------------------------#-T---------T-------------------------------------SSS----------TT----------------------
S-------------------------------------------SS-------------------------#-#---------T----------------T---------------------------------TT----TT----------------
S--------------------------------g------kk---------------------------#-#-#---g-----T----------g-----T---------------------------g-g---T-----T---------kk------
XXXXXXXXXXXXXXXX--XXXXXXXXXXXXXXXXXXXXXXXXXXXXXXXXXXXX--XX----XXXXXXXXXXXXXXXXXXXXXXXXXXXXXXXXXXXXXXXXXX--XX-XXXXXXXXXXXXXXXXXXXXXXXXXXXXXXXXXXXXXXXXXXXXXXXXX
XXXXXXXXXXXXXXXXX-XXXXXXXXXXXXXXXXXXXXXXXXXXXXXXXXXXXX--XX----XXXXXXXXXXXXXXXXXXXXXXXXXXXXXXXXXXXXXXXXXX--XX-XXXXXXXXXXXXXXXXXXXXXXXXXXXXXXXXXXXXXXXXXXXXXXXXX