--------------------------------------------------------------------------------------------------------------------------------------------------------------
--------------------------------------------------------------------------------------------------------------------------------------------------------------
--------------------------------------------------------------------------------------------------------------------------------------------------------------
S---SSSSSSSSSSSSSSSSSSSSSSSSSSSSSSS------------SSSSSSSSSSSSSSSSSSSSSSSSSSSSSSSSSSSSSSSSSSSSSSSSSSSSSSSSSSSSSSSSSSSSSSSSSSSSSSSSSSSSSSSSSSSSSSSSSSSSSSSSS------
S-------------------------------------------------------------SS--------------------------------------SS------------------SS----------------------------------
S-------------------------------------------------------------SS--------------------------------------SS------------------SS----------------------------------
S----------------------------------------------------------So-SS--------------------------------------------SoSS--------S----------------oooooooooo-----------
S----------------------------------------------------------S---S--------------------------------------------SS-S----SS--S-------------------------------------
S---------------------------SS-----------------------------S------------------------------------------------SS-S----SS--S-S---------SS--SSSSSSSSSSSS----------
S---------------------oS----------------------oo--oS---ooS--ooS-SSSS-------------------------------------------SoS--SS--SoS---SS--SSSS--SSSSSSSSSSSSSS--------
S----SSSSS-----QQQ---SSS----------------SST---SSSSSS--SSSS--SSSSSSSS---------#-#-g-#-T-------------------------SSS--SS--SS---SSS----SS--S-S--------SSS--------
S-----------------------------------------TT---------------------------------#-#-#-#-T-----#------------------------------------------------------------------
S-----------------------------------S-----TT-------------------------------#-#-#-#-#-T---g-#-#-----g-#--------------------------------------------------------
S----------------g-------g----------SS----TT-----k--kk---------------------#-#-#-#-#-T---#-#-#-----#-#-#---gSg----------kk-----------------------------g-g----
XXXXXXXXXXXXXXXXXXXXXXXXXXXXXXXXXXXXXX--XXXXXXXXXXXXXXXXXXXXXXXXXXXXXXXXXXXXXXXXXXXXXXXXXXXXXXXXXXXXXXXXXXXXXXXXXXXXXXXXXXXXXXXXXXXXXXXXXXXXXX--XX--XXXXXXXXXX
XXXXXXXXXXXXXXXXXXXXXXXXXXXXXXXXXXXXXX--XXXXXXXXXXXXXXXXXXXXXXXXXXXXXXXXXXXXXXXXXXXXXXXXXXXXXXXXXXXXXXXXXXXXXXXXXXXXXXXXXXXXXXXXXXXXXXXXXXXXXX--XX--XXXXXXXXXX