--------------------------------------------------------------------------------------------------------------------------------------------------------------
--------------------------------------------------------------------------------------------------------------------------------------------------------------
--------------------------------------------------------------------------------------------------------------------------------------------------------------
S-----------SSSSSSSSSSSSSSSSSSSSSSSSSSSSSSSSSSSSSSSSSSS-SSSSSSSSSSSSSSSSSSSSSSSSSSSSSSSSSSSSSSSSSSSSSSSSSSSSSSSSSSSSSSSSSSSSSSSSSSSSSSSSSSSS------------------
S---------------------------------------------------------------------------------------------------------------------------------SS------SS------------------
S---------------------------------------------------------------------------------------------------------------------------------SS------SS------------------
S---------------------------------------------------------------------------------------------------------------------------------SS------SS------------------
S---------------------------------S-----------------------------------------------------------------------------------------------SS------SSSS----------------
S--------------------------------SSSSS--SS----------------------------------------------------------------------------------------SS------S-S-------SSSSS-----
S------------------------------------S--SS--------------------------------------------------------------Sg-------------------------S------oS--------SS--------
S--------g##-------------------------------S-QQ-----QQ------------SSSS--QQ------TT----------------------SS----SQ--------T----TT---SSS-----SS------------------
S--------#-#---T-------------------------------------#--------------------------#--#---------------------S--------------T----T--------------------------------
S--------#-#-#-T-------T-------------------------g-#-#-#---------------------g-----#--------T------------S---------------------------------------------S------
S--------#-#-#--------TT-------------S----------g#-#-#-#-----g---------------#-#------T--g--TT--------kk----kk------SS-T-----------------g-----------#-------X
XXXXXXXXXXXXXXXXXXXXXXXX--XX-----X--XX--XXXXXXXXXXXXXXXXXXXXXXXXXXXXXXXXXXXXXXXXXXXXXXXXXXXXXX-XXXXXXXXXXXXXXXX-----XXXXXXXXXXXXXXXXXXXXXXXXXX-XXXXXXX---XXXXX
XXXXXXXXXXXXXXXXXXXXXXXX--XX-----X--XX--XXXXXXXXXXXXXXXXXXXXXXXXXXXXXXXXXXXXXXXXXXXXXXXXXXXXXXXXXXXXXXXXXXXXXXX-----XXXXXXXXXXXXXXXXXXXXXXXXXXXXXXXXXX--XXXXXX