--------------------------------------------------------------------------------------------------------------------------------------------------------------
--------------------------------------------------------------------------------------------------------------------------------------------------------------
--------------------------------------------------------------------------------------------------------------------------------------------------------------
S------------SSSSSSSSSSSSSSSSSSSSSSSSSSSSSSSSSSSSSSSS-------SS--------SSSSSSSSSSSSSSSSSSSSSSSSSSS--SSSSSSSSSSSSSSSSSSSSSSSSSSSSSSSSSSSSSSSSSSSSSSSSSSSSS------
----------------SSSSSSSS----SSS-----------------------------------------------------------------------------------------------------SS--SS--------------------
----------------SSSSSSSS----SSS-----------------------------------------------------------------------------------------------------SS------------------------
S---------------------SS-SSSSSSS------------------------------------------------------------------------------------------------------------------------------
S--------------------SSS-SSSSSSS------------------------------------------------------------------------------------------------------------------------------
S--------------------SSS-------------------------------------------------------------------SSS----------------------------------------------------------------
S---------------------SS-------g-----------------------------------------------------------------------------S------------------------------------------------
S----------------------S-------SSSSQQQ-------------g-#---------------------------SSS---------------@QQQ----S-#--SSS------------------------#------------------
S----------------------------------------#-#-#-#---#-S----------TT----T------------------------------------#-#-----------T-----------------#-#----------------
S----------------------------------------#-#-#-#------S---------TT----TT---------------------------------###-#-----------T---------------#-#-#----------SS--SX
S----------S---------------------------#-#-#-#-T-------------g--TT----TT--------------------------------####-#-----------T--------------S#-#-#----------SS--SX
XXXXXXXXXXXXXXXXXXXXXXXX-------XXXXXXXXXXXXXXXXXXXX----X-XXXXXXXXXXXXXXXXXXXXXXXXXXX---XXXXXXX--XXXXXXXXXXXXXXXXXXXXXXXXXXXXXXXXXX--XX--XX-X-XXXXXXXXX--XX--XX
XXXXXXXXXXXXXXXXXXXXXXXX-------XXXXXXXXXXXXXXXXXXXXX--XXXXXXXXXXXXXXXXXXXXXXXXXXXXXX--XXXXXXXX--XXXXXXXXXXXXXXXXXXXXXXXXXXXXXXXXXX--XX--XX-XXXXXXXXXXX--XX--XX