--------------------------------------------------------------------------------------------------------------------------------------------------------------
--------------------------------------------------------------------------------------------------------------------------------------------------------------
--------------------------------------------------------------------------------------------------------------------------------------------------------------
S----SSSSSSSSSSSSSSSSSSSSSSSS----------------SSSSSSSSSSS------SSSSSSSSSSSSSSSSSSSSSSSSSSSSSSSSS--------------SSSSSSSSSSSSSSSSSSSSSSSSSSSSSSSSSSSSSSSSSSS------
S---------------------------------------------SS------------------------------------SS--SS--------------------------------------------------------------------
S---------------------------------------------SS------------------------------------SS--SSS-------------------------------------------------------------------
S-----------------------------------------------------------------------------------SS----S-------------------------SS----------------------------------------
S------------------------------------------------------------------------------------------S------------------------------------------------------------------
S---------------------------S-------------------------------------------------------------SS------------------------S-----------------------------------------
S--------------------------------------------------------------------------------------ooo--------------------------SS----------------------------------------
S------------------------------------------------------------#--##-#-------------#----SSSS-------------#-####-------SS-----#------------------------SSS-------
S------T---------------TT-----------------------------------##-###-#-------------#---------------#-#---#--####---------#-#-#-#--------------------------------
S------T------TT-------TT----------------------------#------##-###-#-----------#-#-#-----------#-#-#-#-#-###-#---#-g-#-#-#-#-#-----------g-#------------------
-------T------TT----g--TT----------------------------#------##-##--#-------------#-------k---#-#-#-#-#-#-##--#-#-#-#-#-#---#-#-g---------#-#------------------
XXXXXXXXXXXXXXXXXXXXXXXXXX--XX--XXXXXXXXXXXXXXXXXXXXXX---XXXXXXXXXXXXXXXXXXXXXXXXXXXXXXXXXXXXXXXXXXXXXXXXXXXXXXXXXXXXXXXXXXXXXXXXXXXXXXXXXXXXXXXXX--XXXXXXXXXX
XXXXXXXXXXXXXXXXXXXXXXXXXX--XX--XXXXXXXXXXXXXXXXXXXXXX--XXXXXXXXXXXXXXXXXXXXXXXXXXXXXXXXXXXXXXXXXXXXXXXXXXXXXXXXXXXXXXXXXXXXXXXXXXXXXXXXXXXXXXXXXX--XXXXXXXXXX