--------------------------------------------------------------------------------------------------------------------------------------------------------------
--------------------------------------------------------------------------------------------------------------------------------------------------------------
--------------------------------------------------------------------------------------------------------------------------------------------------------------
S----SSSSSSSSSSSSSSSSSSSSSS-SSSSSSSSSSSSSSSSSSSSSSS--------SSSSSSSSSSSSSSSSSSSSSSSSSSSSSSSSSSSSSSSSSSSSSSSSSSSSSSSSSSSSSSSSSSSSSSSSSSSSSSSSSSSSSSSSSSSSS------
-----------S---------------------------S----------------------------------------------------------------------------------------------------------------------
---------------------------------------S----------------------------------------------------------------------------------------------------------------------
S--------------------------------------SSSSS------------------------------------------ooo---------------------------------------------------------------------
S-------------------------------------------------------------------------------------------------------------------------------------------------------------
S-------------------------------------------------------------------------------------SSSS----------------------SS--------------------------------------------
S-------------------------------------------------------------------------------------SSS-----------------------SS--------------------------------------------
S---------SS-----------------#TT-------S-------------#-#-------------------------T----SS---------------------#---S-----------##-------------------------------
S-------------------------#-#--T------SS-------------#-T-------------------------TT------------------------#-#------------##-###----------T#------------------
S----------------------####-#--T--SS--SS-----------#-#-T--------------------T----TT-----TT-------------------#---------g########---------#-#-------g-#-#------
S----g-----------------#-##--#T#---S--SS------g----#-#ST--------------------TT---TT-----TT---------------g-------------#####--##------g--#-#-------#-#-#------
XXXXXXXXXXXXXXXXXXXXXXXXXXXXXXXX--XX---X-XXXXXXXXXXXXXXX--XXXXXXXXXXXXXXXXXXXXXXXXXXXXXXXXXXXXXXXXXXXXXXXXXXXXXXXX--XXXXXXXX------XXXXXXXXXXXXXXXXXXXXXXXXXX--
XXXXXXXXXXXXXXXXXXXXXXXXXXXXXXXX--XX--XXXXXXXXXXXXXXXXXX--XXXXXXXXXXXXXXXXXXXXXXXXXXXXXXXXXXXXXXXXXXXXXXXXXXXXXXXXXXXXXXXXXX---X--XXXXXXXXXXXXXXXXXXXXXXXXXX--