--------------------------------------------------------------------------------------------------------------------------------------------------------------
--------------------------------------------------------------------------------------------------------------------------------------------------------------
--------------------------------------------------------------------------------------------------------------------------------------------------------------
S-----SSSSSSSSSSS-------------SSSSSSSSSSSSSSSSSSSSSSSSSSSSSSSSSSSSSSSSSSSSSSSSSSSSSSSSSS--SSSSSSSSSSSSSSSSS---SSSSSSSSSSSSSSSSSSSSSSSSSSSSSSSSSSSSSSSSSS------
S---------------------------------------------------------SS----------------SSSSSS----------------------------------------------------------------SS----------
S---------------------------------------------------------SS----------------SSSSSS----------------------------------------------------------------SS----------
S-----------------------------------------------------------------SS--oo--SS--S------SSS---SS------------------------------------------------------S--SS------
S-----------------------------------------------------------------SS-------S--SS------------------------------------------------------------------------------
S-----------------------------------------------------------------SS--SSSSSSS-S-------------------------------------------------------------------------------
S-----------------------------------------------------------------SS------------------------------------------------------------------------------------------
S----------------------------S-------#---------------------------SSS---------------------------------S---------------#-#--------------------------SS----------
S----------------#-#-----------------#-#---#-#-----#--------------SS-----------------#-#----------------------TT---#-#-#--------------------------------------
S----------------#-#-----------------#-#---#-#---#-#-#-----S-#---S-SSS-------SSS---#-#-#----------------TT----TT---#-#-#---S----------------------------------
S----------------#-#---------------#-#-#---#-#---#-#-#-----#-#---#-----------------#-#-#----------------TT-----T-#-#-#-#--------Sk----------------------------
XXXXXXXXXXXXXXXXXXXX----XXXXXXXXXXXXXXXXXXXXXXXXXXXXXXXXX-XX---XXX------XX--XXXXXXXXXXXXXXXXXXXXXXXXXXXXXXXXXXXXXXXXXXXX--X----XXXXXXX---XXXXXXXXXXX-------X--
XXXXXXXXXXXXXXXXXXXXX---XXXXXXXXXXXXXXXXXXXXXXXXXXXXXXXXX-XX-X--XX------XX--XXXXXXXXXXXXXXXXXXXXXXXXXXXXXXXXXXXXXXXXXXXX--X----XXXXXXX---XXXXXXXXXXX-------X--