---------------------------------------------------------------------------------------------------------------------------------------------------X-
-----------------------------------------------------------------------------------------------------------------------------------------------------
-----------------------------------------------------------------------------------------------------------------------------------------------------
----------oo-----------------------------------------o-----------------o-----------------------------------------------------------------------------
----------%%%----------------------------------------%%----------------------------------------------------------------------------------------------
-----------|----------------%%%--------------o-------|--------%%%-----------------------%%%----------------------------------------------------------
-----------|--%%%%%%---------|------------%%%%%------|---------|-------------------------|-----------------------------------------------------------
-----------|---|||---o--SS---|----SS------||||-------|---------|--SSSS---------o-----o---|-o--------------------------SSS----------------------------
-----------|---|||%%%-------%%%%%---------||||-%o----|------%%-|--------------------%%%-%|%-%--------------------------------------------------------
-----------|---|||-|---------|||----------||||-----S-|-------|-|------SSS------------|---|-----------------------------------------------------------
-----------|---|||-|---------||||---------||%%%%-----|-------|||-----o------%%%-%%%%-|---|----------------------------------------%%%----------------
-----------|---|||-|---------||||-%%%---|-||||||%%------%%%%%%||----%%%--o---|---|||||---|---------------------------%%%%%%%%%-----|-----------------
---------------|%%%%%%----%%%%%%%%||----|-||||||||-------||-||||-----|--%%%--|---|||||---||---------------------------|||||||------|-----------------
---------------||||||------||||||-||---|||||||||||-------||-||||-----|---|---|---|||||---||---------------------------|||||||------|-----------------
-------------%%|||||||--%%-||||||-||----||||||||||------%||-||||-----|---|---|---|||||---||----------------XXXX-------|||||||------|-------------XXXX
--------------||||||||--|--||||||-||----||||||||||-------|||||||-----|---|---|---|||||---||------------------X---------||||||------|--------------XXX