-----------------------------------------------------------------------------------------------------------------------------------------------------
-----------------------------------------------------------------------------------------------------------------------------------------------------
-----------------------------------------------------------------------------------------------------------------------------------------------------
-----------------------------------------------------------------------------------------------------------------------------------------------------
-----------------------------------------------------------------------------------------------------------------------------------------------------
---------------------------------------------------------------------------------------o-----------%---------------SS--------------------------------
---------------------------------------------------------------------------------o------------%------%%%--%%%%%--------------------------------------
--------------------SSS-SS---------o-------------------|-----SSS-----------------------------------||||o--------------------SSS------o---------------
-------%-----------------------------------------o-------------------------------------------------||%%%%---------------------------%%%------o-------
-------|---SSSSS-----------------------SSSSSS---%%%----|---o---------------------SS--------o-------|||||------SSS--o-----------------|--o----%S------
------||-----------------------------------------|-----|----r-------------------------------%%%----|||||----------%%%----------------|---------------
------||-----------------------------|-----------|----%%%%%%%%---------%%%%%%%%%%------------||--%-|||||-----------|-------------%%%%|---------------
-----||||---------------------------||-----------|-----||||||-----------||||||||-------------||-|--|||||-----------|--------------||||---------------
-----||||---------------------------||-----------|-----||||||-----------||||||||-------------||-|--|||||-----------|---------%%%%-||||-------------#-
XXXXX||||-------------------XXXXXX--||----------%%%%---||||||%%--------%%||||-||XXXXXXXXXXX--||-|--||||--------%%%%%%%%-------||-||||||%%%%%XXXXXXXXX
XXoXX||||-------------------XX--X---||-----------|||---||||||||---------|||||-||X|XXXXXXXXX--||-|--||||---------||||||--------||-||||||||||-XXXXXXXXX