-----------------------------------------------------------------------------------------------------------------------------------------------------
-----------------------------------------------------------------------------------------------------------------------------------------------------
-----------------------------------------------------------------------------------------------------------------------------------------------------
-----------------------------------------------------------------------------------------------------------------------------------------------------
-----------------------------------------------------------------------------------------------------------------------------------------------------
---------------------------------------------o-----------------------------o--------------%%%--------------------------------------------------------
-------------------------------------------------------------------------------------------|---------------------------------------------------------
--SSS-oo---SSSSS----------------------------------------------------------SSS---------SS---|---o--SSS------------|-r---o----o-------------SSS--------
------%%%----------------------------------------------------------------------------------|--%%%---------------%%%%%-------%%%----------------------
-------|----------SSSS------------------SSS-----------------------------------SSS----------SS--|-------SSSS------|||---------|-----------o-----------
-------|---------------------------------------------------------oooo----------------------|---|-----------------|||---------|-----------------------
-------|------------------%%%%%%%%%%%%%%--------%%%%--------%%%%%%%---------------%--------|---|-----------------|||---------|-----------------------
-------|-------------------|--||--||||-----------||%%%%----|---|-|---------------|---------|---|---|-------------|||------%%%%%%---------------------
-------|-------------------|--||--||||-----------|||||-----|-----|---------------|-----%%%%%%%%%%%-|-------------||||------||||----------------------
------||------------------%%%%%%%%%%%||----------|||||----%%%%%%%%XXXXXXXXXXX---%%%-----|||||||||--|-----------|-|||%%%%%%%||||------%%---------XXXXX
------||-------------------|||||||||||-----------||-||-----|||||||XXXXXXXXXXX-X--|------|||||||||--|-----------|-||||-|%||-||||-------|--------XXXXXX