-----------------------------------------------------------------------------------------------------------------------------------------------------
-----------------------------------------------------------------------------------------------------------------------------------------------------
-----------------------------------------------------------------------------------------------------------------------------------------------------
-------------------------------o---------------------------------------------------o-----------------------------------------------------------------
------------------------------%%%-----------------------------%%%%----------------%%%----------------------------------------------------------------
-------------------------------|-------------o-----------------|-----o-------------|-------------o---o-------------------%%%-------------------------
-------------------------------|---------%%%%%-----------------|----%%%------------|--------%%%-%%%-%%%---o-------oo----------SS---------------------
-------------------------o---|-||-----SSS||||--SS--------------|-----|-------------|-----o---|---|-o-|-------o-----------------S-o-------------------
------------------------%%%%%%%%%%--------|||------------------|-----|--%%%----%%%%%----%%%--|%%-%%%%|------------------%%%%%------------------------
-------------------------|--||||||--------||-------------------|-----|---|-------||------|---||--|-|---o-----S-------SS--|||----------%%%%-----------
-------------------------|--||||||--------||-------------------------|%%-|-------||------|---||-||-|--%------------------||------------||------o-----
--------------%%%%%%-----|--||||||--------||--------------------%%%%%%||-|-------||------|---||--r-|---|-----------------||------------||-%%%%%%%%---
---------------||||%%%-%%%%%%|||||--------||---------------------|||||||-|-------||------%%%%%%%%%%%%%%%%----------------||------------||--||||||----
X--------------|||||||--|||-||||||--------||---------------------|||||||||-------||------||-||||||||||-|---%%%%%%--------||------%%%%%-||--||-|||--o-
XXXXXXXXXXXXXX-|||||||--|||-||||||----%%%-||------XXXXXXXXXXXX---|||||||||---%%||||-XXXX-||-||||||||||-|----|||----%----%%%%%----|||||-|%%%%%%|||---%
XXXXXXXXXXXXX--|||||||--|||-||||||-----|--||------XXXXXXXXXXXX---||||||||------||||-XXXX-||-||||||||||-|----|||----------||------|||||-||||||-|||----