-----------------------------------------------------------------------------------------------------------------------------------------------------
-----------------------------------------------------------------------------------------------------------------------------------------------------
---------------------------------------------------------------------------------------------------------------------o-------------------------------
--------------------------------------------------------------------------------------------------------------------%%%------------------------------
---------------------------------------------o-----------------------------------------------------------------------|-------------------------------
----------------------%%%------------------%%%%--------o------------------------------%%%----------------------------|---o---------------------------
---------------------------------------------|------------------------------%%%--------|-------------o---------%%----|--%%%----S---------------------
---------------SSS---------------------------|-----SS------------------------|---S-----|-----o-------o------%%%%|----|---|--SSS----------------------
-----------S------------------------------%%%|--------------------%%%-------%%%%%%%----|----%%%------|--%%%--|||-----|---|---------------------------
-------------------SSS---------------------|-|--------S------------|-----|---|||||-----|-----|-------|---|---|||-----|---|-------SSS-----------------
-------------------------------------------|-|---------------------|--%--|---||||------|%%%--|-------|---|---|||-----|---|--------------------o------
-------------------------------------------|-|---------------------|-|---|---||||--------|---|-------|---|---|||-----|---|---------------------------
-------------------------------------------%%%%%-------------------|-|---|---|%%%%%%---|-|---|----%%%%%%-|---||||--------%%%%------------------------
--------o-------------------%%%%%%%---------|||--------------------|-|---|--r|-||-|----|-|---|-----||||--|---||||--------|||---------o-------------o-
XX-----%%%--%%%---------%%%--|||||---%%%%%%-|||----------------%%%%%%%%%%%%%%%-||-||-%%%%%%%-||----||||--%%%-||||----%%%-|||-----------------------X%
XX------|----|------------|--|||||----|||||-|||-----------------|||||||-|||||--||-|||-|||||--||----||||--||--||||-----||-|||-----------------------|-