-----------------------------------------------------------------------------------------------------------------------------------------------------
-----------------------------------------------------------------------------------------------------------------------------------------------------
-----------------------------------------------------------------------------------------------------------------------------------------------------
---------------------------------------------------------------------------o-------------------------------------------------------------------------
--------------------------------------------------------------------------%%%------------------------------------------------------------------------
--------------oo-------o------------------------%%%------------------------|-----------------o-----o-------------------------------------------------
-------------%%%%-----%%%-------------------%%---|-------------------------|----------------------%%%%--%---------------------------------%%%--------
----SSS-------||-------|-------o-------------|---|---o---oo-------SSS------|------SSS--------------||--o----SSSS-----------oo--------------|---------
--------------||------%%%----%%%%------------|---|---%--%%%%------------%%-|-----------------------||--|------------------%%%%-------------|---------
--------------||--oo---|---%|-||-------------|---|---|---||--------o-----|-------------------------||--|-------------------||--------------|---------
-------------%%%%%%%%--|--||%-||-------------|---|---|---||--------------|--o----o-----o----r------||--|--------------o----||--------------|--%%%----
------------|-|||||----|---||-||----------||||---|-------|---------------|--%%%%------%%%-%%%%%%r--|---|------------%%%%%%-||--%%%%%%%%%%%%%%--|-----
------------|-|||||%o%-|--|||-||--%%%%%---||||---|----%%%%%--------------|---|||-------|---||||%%%%%%%%%%------------||||--|-----|-||--||||||--|-----
------------|||||||-|--|--|||-||---|||%%--||||---|----||||---------------|---|-||------|---||||||||||||--------------||||--|-----|-||--||||||--|---o-
XXXXXXXXXXX-|||||||%%%%|--|||-||----|||---||||--%%%----|||--%%%----------|---|-||--%%%%|%--||||||||||||--------XXXXXX|||%%%%%%%%%%%%%%%||||||--|--%%%
XXXXXXXXXX--||||||||||||--|||-||----|||---||||---|-----|||---||----------|---|-||---|||||--||||||||||||--------XXXXXX||||||||||||||||||||||||--||--|-