-----------------------------------------------------------------------------------------------------------------------------------------------------
-----------------------------------------------------------------------------------------------------------------------------------------------------
-----------------------------------------------------------------------------------------------------------------------------------------------------
-----------------------------------------------------------------------------------------o-----------------------------------------------------------
----------------------------------------------------------------------------------------%%%----------------------------------------------------------
--------------%%%-----%%%--------------o-----------------o-------------------------------|---o---o---------------------------------------------------
-----------------------|------%%%%----%%%---------------%%%------------------------------|--%%%%%%%--------------------------S-----------------------
------SSSS-------SS----|-----SS||------|-----o----SSS----|-------------------------------o---||--|--o----SSS------SSS------SS----------------SS------
-----------------------|-------|-------|-----------------|----------------------------%%%%%--||--||%%------------------------------------------------
------------SS---------|SS-----|-------|-----SSS---------|---------SSS-----------------|-|-r-||--|-|---------SSS--------SS-----SSS-----SSS-----------
---------------%%%-------------|-------|-----------------|----------------------------%%%|-%-||%-|-|-------------------------------------------------
----------------||-------------|-------|-----------------|-----------------------%%%%%%||||--|||-|-|-|-----------------------------------------------
----------------||-------------|---%%%%%%%%%%%%----------|------------------------|||||||||-||||%%%%%%%%---------------------------------------------
----------------||-------------|----|||||-||-|-----------|------------------------|||||||||-|||||--||||----------------------------------------------
XXXXXXXX--------||------%%%%%%%%%%%-|||||-||-|-----XXX---|-------------XXXXXXXXXX-|||||||||-|||||--||||----------XXXXXXXXXXXX--------------%%--------
XXXXXX-X--------||-------||||||||||-|||||-||-|-----XX------------------XXXXXXXXXX-|||||||||-|||||--||||-|--------XXXXXXXXXXXX---------------|--------