-----------------------------------------------------------------------------------------------------------------------------------------------------
-----------------------------------------------------------------------------------------------------------------------------------------------------
-----------------------------------------------------------------------------------------------------------------------------------------------------
-----------------------------------------------------------------------------------------------------------------------------------------------------
-----------------------------------------------------------------------------------------------------------------------------------------------------
-----------------------------------------------o-----------------o---------------------------------------------------------o-------------------------
-------------------------||-------------------%%%---------------%%%%-------o------%%%---------------------%%%-------------%%%------------------------
---------------------|--|||-----SSS------o-----|---------o-------||-------------SS-|---------SSSSS---------|---------------|-------------------------
-------------%%%-----|--||||----------%%%%%%%--|-----------------||----------------|-----------------------|---------------|------%%%%---------------
------S-------||-----|--||||-----------|||||------SSS---%%%%-----||----|-SSS---o---|-----SS------------o---|---o-----------|---o---||--------------X-
--------------||-----|--||||--------%%-|||||-------------||-%%%%-||-|---------%-%-%%%%%--------------------|---------------|---%%%-||--------------X-
--------------|------|--|||----------|||||||-------------||-|%%%%||||----------|---|||-----------------%%%-%|%-%%-%%%%-----|----|--||----%%%%--------
--------------|------|--||||---------|||%%%|-------------||||||||||||----------|---|||-----------------|||-%|-|||--||------|----|--||-----||---------
--------------|------|--||||--%%%----|||||||-------------||-|||||||||----o-----|---|||-----------------|||-||-|||--||------|----|--||-----||---------
XX------%%%%%%|----%%%%-||||---|-----|||||||%%%%------%%%%%%|||||||||--------%---|-|||-------------%%%%%%%|||-|||--||------%%%%%%%%%%%%%%%%%%%-----oX
XX-------||||||-----|||-||||---|-----|||||||||||-|------|||||||||||||------------|||||-------------||||||||||--||--||------||||||--||||||||||--------