-----------------------------------------------------------------------------------------------------------------------------------------------------
-----------------------------------------------------------------------------------------------------------------------------------------------------
-----------------------------------------------------------------------------------------------------------------------------------------------------
-------------------------------------------------------------------o---------------------------------------------------------------------------------
------------------------------------------------------------------%%%--------------------------------------------------------------------------------
------o------------------------o-----------------------------------|---------------------------------------------------------------------------------
-----------------------S------%%%-----------------o----------------|------------------------------------------------%%%%-----------------o-----------
---------------------SSS-------|-------S------------o--------------|--------SS---------------------------------------||-oo---SSS-o-------%-----------
-------------------------------|-----------------------------------|--o----------------------------------------%%%%--||--%---------------|-----------
-----------------S----------------SS----------------------SSSS-----|---S---------------------------------------||||--||--|--------SS-----|-----------
-----------|--------------------------------------------------%%%%-|--------------------------------r--------%-||||--||--|---------------|-----------
-----%%%%--|---------------------------------------------------|||-|------------%%%------------%%%%%%----------||||--||--|-------o---|---|-----------
------||-%%%%%%%%----------------------------------------------||||||------------|--------------||||----------%|%%|%-||-%-------%%%%-|--%%%%%%-------
X-----||--||-|||------------------------------------------%%%%-||||||------------|--------------||||---------|-||||--||----------||--|---||-|--------
XXXXX-||--||-|||----------------------XXX------------------||--||||||---------%%-|--------------||||---------|-||||--||----------||----%-||-|----XXXX
XXXXX-||--||-|||----------------------XX-------------------||--||||||----------|-||-------------|||----------||||||--||----------||------||-|----XXXX