-----------------------------------------------------------------------------------------------------------------------------------------------------
-----------------------------------------------------------------------------------------------------------------------------------------------------
-----------------------------------------------------------------------------------------------------------------------------------------------------
-----------------------------------------------------o-----------------------------------------------------------------------------------------------
----------------------------------------------------%%%------------------------------------ooo--------------------------------------------%%%%-------
-----------------------------------------------------|---------o--------------------------%%%%---------------------------------------------||--------
---------------------------------------o---------------------%%%%-------%%%----------------||-----------------------------------------%%%--||--------
----oo----SSS------o---------o-----------------------|---------|---------|-----------------||----SS----------------------------SS------|---||-S------
----%%%----------------------------------------|----%%%%%--|---|---------|-----------------||-----------------------------------------|||--|---------
-----|------------%%%-SSS-------SSSS-----------|-----|||---|---|-----o---|---------o-------||-----------------SSS--------SSSS---------|||--|-----SS--
-----|------------||---------------------------|-----|||%%-|---|---------|--------%%%------||-----------------------------------------|||--|---------
-----|---------|--||---------------------------|-----||||--|---|---------||--------|-------||-%%%%------------------------------%%%%--|||------------
----%%%%%%-----|--||---------------------------||%%%%||||--|---|%%%%%----||-%%%----|--%%%%%%|%|||---------------------------------|-%%%%|%-----------
-----|||||-----|--||-----------------o--%%%%%%-||-|||||||--|---||-||-----||-||-----|---||--||-||||--------------------------------|--||||------------
X----|||||---%%%%%||----------------%%%--||||--||-|||||||-%%%%-||-||-----||-||-----|---||--||-||||-----XXXXXXXXXXXXXXXXXXXXXXX-X-||--||||-%%----XXXXX
-----|||||----|||-||---------------------||||--||-|||||||-|||--||-||-----||-||---------||--||-||||-----XXXXXX-XXXX--X-XXXXXXX----||--||||-|-----XXXXX