----------------------------------------------------------------------------------------------------------------------------------------------------------------------------
SSSSSSSSSSSSSSSSSSSSSSSSSSSSSS-SSSSSSS---S-SSS-SSSSSS----SSSSSSSSSSSSSSSSSSSSSSSSSSSSSSSSSSSSSSSSSS-SS---SSSSSSSSSSSSSSSSSS-SSSSSSSSSSSSSSSSSSSSSSSSSSSSSSSSSSSSSSSSSSSSSSSS
S--------S--------SS--------------------------------------------SSSSSSS------------------SS------------------S----------------S----SSSSS-------S---SSSS----------SSS--------
S---------------SSoSS----------------------------------------------SSoSo-----------------------------------S-T--U-----TU----SSSS---Soo--------------SSg----------SSoS-------
S--------------SSSSS2---------SS-SS--QS--SSSSSS-------------------SSSoo----------------------------------------S--T---T---------S---------------------S--------SSSSS-2------
S-----------------------------------2-S----gg---SS----------------SS------------------------S----------------------------T------------SgS------------------SSS2ooS----------
S-----------T------?-----------------Q------S----------------22---SS-o------------------SSSSSS---SSS---S-------S--ogo-------------------S-----------------SS----------------
S-------------------S--------------------------T---------------2--------T----------------SSSSSS22SSSSSSSS--S-----S----------------------SS-----------------So-S-------------
S-----------------So---S-----------SS-------S--T-S-SS----------S--------TSS---S-S-S--T-------------SSSSSSS------------------------------ooo---------------S---SgS-----------
S--------S-SS----SSSSSSSS--S---SSS----S--------T--S---------------------T------------T-----SSS-------SSSSSSS-----------------------------g---S--------------oSSggS----------
S--------SS--S---S-----------------------------T---------------------S--------g-----------S-Sg------ooooS------------------------------ooo--S2-S2---------S-SSSgSS---------S
S------------------------------SSSSS-------------------------------S-------SSSSS------------SSSS------g------------------------S-2---TSSSgSS------------------S--S----------
S----------------------------S-S-ooS-S----------SSSSS------------S-S--------Sooo----------S-SS--S--------------------------------gS--TSSSS----------SSS------SoSo-----------
---Q------#SSTU-T-SCTU#ST--------SSST-------T-#T--QQ---S---CT--TUS-S----TT-T--SSSS-CTTTT----S----#S----C------#------T-U-TS----Q-Q---TSS----------Q----C-SS--SSSQ?Q-------T-
--------#-#SCT-kTT-kT-#S--TS-S---S-kT-------T-#--------St---T--T------kkkT-T-------k--TT-T-#-----#-T-T-k------S--k--kkkTTk--------k--T-#SS--------------t-k-kTSSk--T------TS
XXXX-XXXXXXXXXXXXXXXXXXXXXXX-XXXXXXXX-XXXXXXXXXXXXXX--XXXXXXXXXX-XXXXXXXXXXXXXXXXXXXXXXXXXXXXXXXXXXXXXXXXXXXXXXXXXXXXXXXXXXXXXXXXXXXXXXX--XXX-XXXXX-X-XXXXXXXXXXXXXXXXXXXXX-