-------------------------------------------------------------------------------------------------------------------------------------------------------------------------------------------------------------------------------------------------------------------------------------------------------------------------------------------------------------------------------------
-------------------------------------------------------------------------------------------------------------------------------------------------------------------------------------------------------------------------------------------------------------------------------------------------------------------------------------------------------------------------------------
-------------------------------------------------------------------------------------------------------------------------------------------------------------------------------------------------------------------------------------------------------------------------------------------------------------------------------------------------------------------------------------
-------------------------------------------------------------------------------------------------------------------------------------------------------------------------------------------------------------------------------------------------------------------------------------------------------------------------------------------------------------------------------------
-------------------------------------------------------------------------------------------------------------------------------------------------------------------------------------------------------------------------------------------------------------------------------------------------------------------------------------------------------------------------------------
-------------------------------------------------------------------------------------------------------------------------------------------------------------------------------------------------------------------------------------------------------------------------------------------------------------------------------------------------------------------------------------
-------------------------------------------------------------------------------------------------------------------------------------------------------------------------------------------------------------------------------------------------------------------------------------------------------------------------SSSSCSSS----------------------------------------------------
------o--------------------------------------------------------------------------------------------------------------------------------------------------------------------------------------------------------------------------o---------------------------------------------------------------------------------------------------------------------------------------------------
-----------------------------------------------------------------------------------------------------------------------------------------------------------------------------------------------SSSSUSSS------------------------------------------------------------------------------------------------------------------------------------------------------------------------------
-------------------------------------------------------------------------------------------o---------------------------------------------------------------------------#-------------------------------------------------------------------------------------------------------------------------------------------------------------------------------------------------------------
-----------------------------o------------------------------------------------oo-----o--------------------------------------------------------------------------------##---------------------------------------------------------------------------------------------------TT----------oo--T-----------------------------------------------------------------------------------------
----------------------TT---------------------------------------------------------------------TT------------------------------------T---------------------------------###-------------------------------------------------------TT--------------------------T---------------TT--------------TT----------------------------------------TT----------------------------------------------
----------------------TT-------------------------------------#-------------------------------TT--------------#--------------------TT-------------------------------###-#-------#-----------------------------------------------TT--------------------------TT----t----------T------T-------TT----------------------------------------TT----------------------------------------------
--------k-gg----------TT--------ggg---------------------#--k-#----kkk----ggg----k-k----------TT---ggg--------#-k----k-k-k-k-----k-T------------------------------k--##-#-----kk#--------k-----------------k-k-------k-k---ggg--TT---------k-------ggg------T-----t-gg-------T------TT------TT------------------------------kk--------TT------------gg--------------------k-----------
XXXXXXXXXXXXXXXX--XXXXXXXXXXXXXXXXXXXXXXXXXXXXXXXXXXXXXXXXXXXXXXXXXXXXXXXXXXXXX-XXXXXXXXXXXXXXXXXXXXXXXXXXXXXXXXXXXXXXXXXXXXXXXXXXXXXXXXXXX-X-XX--X-XXXXXXXXXXXXXXXXXX-XXXXXXXXXXXXXXXXXXXXXXX-X------X-XXXXX-XXXXXXXXXXXXXXXXXXXXXXXXXXXXXXXXXXXXXXXXXXXXXX-X---XXXXXXXXXXXXXXXXX-XX---XXXXXXXXXXXXXXX---XXXX-XX--XXXXXXXXXXXXXXXXXXXXXXXXXXXXXXXXXXXXXXXXXXXXXXXXXXXXXXXXXXXXXXXXXX
XXXXXXXXXXXXXXXX--XXXXXXXXXXXXXXXXXXXXXXXXXXXXXXXXXXXXXXXXXXXXXXXXXXXXXXXXXXXXXXXXXXXXXXXXXXXXXXXXXXXXXXXXXXXXXXXXXXXXXXXXXXXXXXXXXXXXXXXXX-XXXX--X-XXXXXXXXXXXXXXXXXXXXXXXXXXXXXXXXXXXXXXXXXXXXX-----X-XXXXX-XXXXXXXXXXXXXXXXXXXXXXXXXXXXXXXXXXXXXXXXXXXXXX-XX--XXXXXXXXXXXXXXXXXXXX-XXXXXXXXXXXXXXXXX---XXXXXXX--XXXXXXXXXXXXXXXXXXXXXXXXXXXXXXXXXXXXXXXXXXXXXXXXXXXXXXXXXXXXXXXXXX